CAAGGACCGCC: AAGGACCGCCT
AAGGACCGCCT: AGGACCGCCTG
AGGACCGCCTG: GGACCGCCTGC
GGACCGCCTGC: GACCGCCTGCC
GACCGCCTGCC: ACCGCCTGCCG
ACCGCCTGCCG: CCGCCTGCCGG
CCGCCTGCCGG: CGCCTGCCGGA
CGCCTGCCGGA: GCCTGCCGGAC
GCCTGCCGGAC: CCTGCCGGACT
CCTGCCGGACT: CTGCCGGACTG
CTGCCGGACTG: TGCCGGACTGG
TGCCGGACTGG: GCCGGACTGGC
GCCGGACTGGC: CCGGACTGGCA
CCGGACTGGCA: CGGACTGGCAA
CGGACTGGCAA: GGACTGGCAAT
GGACTGGCAAT: GACTGGCAATC
GACTGGCAATC: ACTGGCAATCA
ACTGGCAATCA: CTGGCAATCAG
CTGGCAATCAG: TGGCAATCAGG
TGGCAATCAGG: GGCAATCAGGA
GGCAATCAGGA: GCAATCAGGAC
GCAATCAGGAC: CAATCAGGACT
CAATCAGGACT: AATCAGGACTT
AATCAGGACTT: ATCAGGACTTT
ATCAGGACTTT: TCAGGACTTTC
TCAGGACTTTC: CAGGACTTTCA
CAGGACTTTCA: AGGACTTTCAA
AGGACTTTCAA: GGACTTTCAAG
GGACTTTCAAG: GACTTTCAAGG
GACTTTCAAGG: ACTTTCAAGGA
ACTTTCAAGGA: CTTTCAAGGAC
CTTTCAAGGAC: TTTCAAGGACT
TTTCAAGGACT: TTCAAGGACTC
TTCAAGGACTC: TCAAGGACTCG
TCAAGGACTCG: CAAGGACTCGC
CAAGGACTCGC: AAGGACTCGCT
AAGGACTCGCT: AGGACTCGCTA
AGGACTCGCTA: GGACTCGCTAT
GGACTCGCTAT: GACTCGCTATG
GACTCGCTATG: ACTCGCTATGT
ACTCGCTATGT: CTCGCTATGTC
CTCGCTATGTC: TCGCTATGTCG
TCGCTATGTCG: CGCTATGTCGG
CGCTATGTCGG: GCTATGTCGGG
GCTATGTCGGG: CTATGTCGGGG
CTATGTCGGGG: TATGTCGGGGC
TATGTCGGGGC: ATGTCGGGGCA
ATGTCGGGGCA: TGTCGGGGCAA
TGTCGGGGCAA: GTCGGGGCAAG
GTCGGGGCAAG: TCGGGGCAAGA
TCGGGGCAAGA: CGGGGCAAGAT
CGGGGCAAGAT: GGGGCAAGATT
GGGGCAAGATT: GGGCAAGATTC
GGGCAAGATTC: GGCAAGATTCT
GGCAAGATTCT: GCAAGATTCTC
GCAAGATTCTC: CAAGATTCTCG
CAAGATTCTCG: AAGATTCTCGT
AAGATTCTCGT: AGATTCTCGTT
AGATTCTCGTT: GATTCTCGTTC
GATTCTCGTTC: ATTCTCGTTCC
ATTCTCGTTCC: TTCTCGTTCCT
TTCTCGTTCCT: TCTCGTTCCTA
TCTCGTTCCTA: CTCGTTCCTAT
CTCGTTCCTAT: TCGTTCCTATG
TCGTTCCTATG: CGTTCCTATGT
CGTTCCTATGT: GTTCCTATGTT
GTTCCTATGTT: TTCCTATGTTT
TTCCTATGTTT: TCCTATGTTTA
TCCTATGTTTA: CCTATGTTTAT
CCTATGTTTAT: CTATGTTTATC
CTATGTTTATC: TATGTTTATCC
TATGTTTATCC: ATGTTTATCCT
ATGTTTATCCT: TGTTTATCCTT
TGTTTATCCTT: GTTTATCCTTC
GTTTATCCTTC: TTTATCCTTCC
TTTATCCTTCC: TTATCCTTCCA
TTATCCTTCCA: TATCCTTCCAG
TATCCTTCCAG: ATCCTTCCAGC
ATCCTTCCAGC: TCCTTCCAGCG
TCCTTCCAGCG: CCTTCCAGCGT
CCTTCCAGCGT: CTTCCAGCGTG
CTTCCAGCGTG: TTCCAGCGTGT
TTCCAGCGTGT: TCCAGCGTGTT
TCCAGCGTGTT: CCAGCGTGTTT
CCAGCGTGTTT: CAGCGTGTTTA
CAGCGTGTTTA: AGCGTGTTTAC
AGCGTGTTTAC: GCGTGTTTACG
GCGTGTTTACG: CGTGTTTACGA
CGTGTTTACGA: GTGTTTACGAC
GTGTTTACGAC: TGTTTACGACA
TGTTTACGACA: GTTTACGACAG
GTTTACGACAG: TTTACGACAGG
TTTACGACAGG: TTACGACAGGT
TTACGACAGGT: TACGACAGGTC
TACGACAGGTC: ACGACAGGTCG
ACGACAGGTCG: CGACAGGTCGG
CGACAGGTCGG: GACAGGTCGGC
GACAGGTCGGC: ACAGGTCGGCC
ACAGGTCGGCC: CAGGTCGGCCT
CAGGTCGGCCT: AGGTCGGCCTG
AGGTCGGCCTG: GGTCGGCCTGA
GGTCGGCCTGA: GTCGGCCTGAA
GTCGGCCTGAA: TCGGCCTGAAA
TCGGCCTGAAA: CGGCCTGAAAT
CGGCCTGAAAT: GGCCTGAAATC
GGCCTGAAATC: GCCTGAAATCG
GCCTGAAATCG: CCTGAAATCGA
CCTGAAATCGA: CTGAAATCGAG
CTGAAATCGAG: TGAAATCGAGC
TGAAATCGAGC: GAAATCGAGCG
GAAATCGAGCG: AAATCGAGCGC
AAATCGAGCGC: AATCGAGCGCG
AATCGAGCGCG: ATCGAGCGCGG
ATCGAGCGCGG: TCGAGCGCGGG
TCGAGCGCGGG: CGAGCGCGGGA
CGAGCGCGGGA: GAGCGCGGGAC
GAGCGCGGGAC: AGCGCGGGACC
AGCGCGGGACC: GCGCGGGACCT
GCGCGGGACCT: CGCGGGACCTA
CGCGGGACCTA: GCGGGACCTAT
GCGGGACCTAT: CGGGACCTATT
CGGGACCTATT: GGGACCTATTG
GGGACCTATTG: GGACCTATTGT
GGACCTATTGT: GACCTATTGTG
GACCTATTGTG: ACCTATTGTGT
ACCTATTGTGT: CCTATTGTGTC
CCTATTGTGTC: CTATTGTGTCG
CTATTGTGTCG: TATTGTGTCGT
TATTGTGTCGT: ATTGTGTCGTC
ATTGTGTCGTC: TTGTGTCGTCT
TTGTGTCGTCT: TGTGTCGTCTC
TGTGTCGTCTC: GTGTCGTCTCA
GTGTCGTCTCA: TGTCGTCTCAA
TGTCGTCTCAA: GTCGTCTCAAC
GTCGTCTCAAC: TCGTCTCAACC
TCGTCTCAACC: CGTCTCAACCT
CGTCTCAACCT: GTCTCAACCTT
GTCTCAACCTT: TCTCAACCTTG
TCTCAACCTTG: CTCAACCTTGA
CTCAACCTTGA: TCAACCTTGAA
TCAACCTTGAA: CAACCTTGAAT
CAACCTTGAAT: AACCTTGAATA
AACCTTGAATA: ACCTTGAATAT
ACCTTGAATAT: CCTTGAATATC
CCTTGAATATC: CTTGAATATCC
CTTGAATATCC: TTGAATATCCT
TTGAATATCCT: TGAATATCCTC
TGAATATCCTC: GAATATCCTCC
GAATATCCTCC: AATATCCTCCC
AATATCCTCCC: ATATCCTCCCG
ATATCCTCCCG: TATCCTCCCGC
TATCCTCCCGC: ATCCTCCCGCT
ATCCTCCCGCT: TCCTCCCGCTT
TCCTCCCGCTT: CCTCCCGCTTG
CCTCCCGCTTG: CTCCCGCTTGT
CTCCCGCTTGT: TCCCGCTTGTT
TCCCGCTTGTT: CCCGCTTGTTT
CCCGCTTGTTT: CCGCTTGTTTT
CCGCTTGTTTT: CGCTTGTTTTA
CGCTTGTTTTA: GCTTGTTTTAG
GCTTGTTTTAG: CTTGTTTTAGG
CTTGTTTTAGG: TTGTTTTAGGT
TTGTTTTAGGT: TGTTTTAGGTT
TGTTTTAGGTT: GTTTTAGGTTG
GTTTTAGGTTG: TTTTAGGTTGG
TTTTAGGTTGG: TTTAGGTTGGG
TTTAGGTTGGG: TTAGGTTGGGC
TTAGGTTGGGC: TAGGTTGGGCC
TAGGTTGGGCC: AGGTTGGGCCC
AGGTTGGGCCC: GGTTGGGCCCC
GGTTGGGCCCC: GTTGGGCCCCT
GTTGGGCCCCT: TTGGGCCCCTG
TTGGGCCCCTG: TGGGCCCCTGT
TGGGCCCCTGT: GGGCCCCTGTT
GGGCCCCTGTT: GGCCCCTGTTC
GGCCCCTGTTC: GCCCCTGTTCG
GCCCCTGTTCG: CCCCTGTTCGA
CCCCTGTTCGA: CCCTGTTCGAT
CCCTGTTCGAT: CCTGTTCGATT
CCTGTTCGATT: CTGTTCGATTT
CTGTTCGATTT: TGTTCGATTTG
TGTTCGATTTG: GTTCGATTTGT
GTTCGATTTGT: TTCGATTTGTG
TTCGATTTGTG: TCGATTTGTGA
TCGATTTGTGA: CGATTTGTGAT
CGATTTGTGAT: GATTTGTGATG
GATTTGTGATG: ATTTGTGATGG
ATTTGTGATGG: TTTGTGATGGA
TTTGTGATGGA: TTGTGATGGAA
TTGTGATGGAA: TGTGATGGAAA
TGTGATGGAAA: GTGATGGAAAA
GTGATGGAAAA: TGATGGAAAAG
TGATGGAAAAG: GATGGAAAAGG
GATGGAAAAGG: ATGGAAAAGGC
ATGGAAAAGGC: TGGAAAAGGCA
TGGAAAAGGCA: GGAAAAGGCAA
GGAAAAGGCAA: GAAAAGGCAAT
GAAAAGGCAAT: AAAAGGCAATT
AAAAGGCAATT: AAAGGCAATTC
AAAGGCAATTC: AAGGCAATTCG
AAGGCAATTCG: AGGCAATTCGA
AGGCAATTCGA: GGCAATTCGAC
GGCAATTCGAC: GCAATTCGACA
GCAATTCGACA: CAATTCGACAT
CAATTCGACAT: AATTCGACATC
AATTCGACATC: ATTCGACATCC
ATTCGACATCC: TTCGACATCCA
TTCGACATCCA: TCGACATCCAG
TCGACATCCAG: CGACATCCAGC
CGACATCCAGC: GACATCCAGCC
GACATCCAGCC: ACATCCAGCCA
ACATCCAGCCA: CATCCAGCCAC
CATCCAGCCAC: ATCCAGCCACA
ATCCAGCCACA: TCCAGCCACAC
TCCAGCCACAC: CCAGCCACACC
CCAGCCACACC: CAGCCACACCC
CAGCCACACCC: AGCCACACCCT
AGCCACACCCT: GCCACACCCTT
GCCACACCCTT: CCACACCCTTT
CCACACCCTTT: CACACCCTTTG
CACACCCTTTG: ACACCCTTTGA
ACACCCTTTGA: CACCCTTTGAC
CACCCTTTGAC: ACCCTTTGACT
ACCCTTTGACT: CCCTTTGACTG
CCCTTTGACTG: CCTTTGACTGG
CCTTTGACTGG: CTTTGACTGGA
CTTTGACTGGA: TTTGACTGGAA
TTTGACTGGAA: TTGACTGGAAC
TTGACTGGAAC: TGACTGGAACA
TGACTGGAACA: GACTGGAACAG
GACTGGAACAG: ACTGGAACAGA
ACTGGAACAGA: CTGGAACAGAG
CTGGAACAGAG: TGGAACAGAGG
TGGAACAGAGG: GGAACAGAGGT
GGAACAGAGGT: GAACAGAGGTG
GAACAGAGGTG: AACAGAGGTGA
AACAGAGGTGA: ACAGAGGTGAG
ACAGAGGTGAG: CAGAGGTGAGG
CAGAGGTGAGG: AGAGGTGAGGC
AGAGGTGAGGC: GAGGTGAGGCG
GAGGTGAGGCG: AGGTGAGGCGC
AGGTGAGGCGC: GGTGAGGCGCA
GGTGAGGCGCA: GTGAGGCGCAG
GTGAGGCGCAG: TGAGGCGCAGT
TGAGGCGCAGT: GAGGCGCAGTG
GAGGCGCAGTG: AGGCGCAGTGT
AGGCGCAGTGT: GGCGCAGTGTG
GGCGCAGTGTG: GCGCAGTGTGA
GCGCAGTGTGA: CGCAGTGTGAC
CGCAGTGTGAC: GCAGTGTGACC
GCAGTGTGACC: CAGTGTGACCA
CAGTGTGACCA: AGTGTGACCAC
AGTGTGACCAC: GTGTGACCACA
GTGTGACCACA: TGTGACCACAA
TGTGACCACAA: GTGACCACAAC
GTGACCACAAC: TGACCACAACC
TGACCACAACC: GACCACAACCA
GACCACAACCA: ACCACAACCAT
ACCACAACCAT: CCACAACCATA
CCACAACCATA: CACAACCATAG
CACAACCATAG: ACAACCATAGT
ACAACCATAGT: CAACCATAGTC
CAACCATAGTC: AACCATAGTCT
AACCATAGTCT: ACCATAGTCTC
ACCATAGTCTC: CCATAGTCTCA
CCATAGTCTCA: CATAGTCTCAA
CATAGTCTCAA: ATAGTCTCAAG
ATAGTCTCAAG: TAGTCTCAAGC
TAGTCTCAAGC: AGTCTCAAGCT
AGTCTCAAGCT: GTCTCAAGCTT
GTCTCAAGCTT: TCTCAAGCTTG
TCTCAAGCTTG: CTCAAGCTTGC
CTCAAGCTTGC: TCAAGCTTGCA
TCAAGCTTGCA: CAAGCTTGCAT
CAAGCTTGCAT: AAGCTTGCATG
AAGCTTGCATG: AGCTTGCATGC
AGCTTGCATGC: GCTTGCATGCA
GCTTGCATGCA: CTTGCATGCAA
CTTGCATGCAA: TTGCATGCAAA
TTGCATGCAAA: TGCATGCAAAT
TGCATGCAAAT: GCATGCAAATA
GCATGCAAATA: CATGCAAATAC
CATGCAAATAC: ATGCAAATACT
ATGCAAATACT: TGCAAATACTT
TGCAAATACTT: GCAAATACTTG
GCAAATACTTG: CAAATACTTGC
CAAATACTTGC: AAATACTTGCC
AAATACTTGCC: AATACTTGCCT
AATACTTGCCT: ATACTTGCCTC
ATACTTGCCTC: TACTTGCCTCA
TACTTGCCTCA: ACTTGCCTCAT
ACTTGCCTCAT: CTTGCCTCATA
CTTGCCTCATA: TTGCCTCATAA
TTGCCTCATAA: TGCCTCATAAG
TGCCTCATAAG: GCCTCATAAGG
GCCTCATAAGG: CCTCATAAGGT
CCTCATAAGGT: CTCATAAGGTC
CTCATAAGGTC: TCATAAGGTCG
TCATAAGGTCG: CATAAGGTCGG
CATAAGGTCGG: ATAAGGTCGGT
ATAAGGTCGGT: TAAGGTCGGTT
TAAGGTCGGTT: AAGGTCGGTTA
AAGGTCGGTTA: AGGTCGGTTAA
AGGTCGGTTAA: GGTCGGTTAAA
GGTCGGTTAAA: GTCGGTTAAAG
GTCGGTTAAAG: TCGGTTAAAGG
TCGGTTAAAGG: CGGTTAAAGGT
CGGTTAAAGGT: GGTTAAAGGTC
GGTTAAAGGTC: GTTAAAGGTCA
GTTAAAGGTCA: TTAAAGGTCAG
TTAAAGGTCAG: TAAAGGTCAGT
TAAAGGTCAGT: AAAGGTCAGTA
AAAGGTCAGTA: AAGGTCAGTAC
AAGGTCAGTAC: AGGTCAGTACT
AGGTCAGTACT: GGTCAGTACTC
GGTCAGTACTC: GTCAGTACTCG
GTCAGTACTCG: TCAGTACTCGA
TCAGTACTCGA: CAGTACTCGAT
CAGTACTCGAT: AGTACTCGATC
AGTACTCGATC: GTACTCGATCA
GTACTCGATCA: TACTCGATCAA
TACTCGATCAA: ACTCGATCAAT
ACTCGATCAAT: CTCGATCAATG
CTCGATCAATG: TCGATCAATGT
TCGATCAATGT: CGATCAATGTG
CGATCAATGTG: GATCAATGTGC
GATCAATGTGC: ATCAATGTGCT
ATCAATGTGCT: TCAATGTGCTC
TCAATGTGCTC: CAATGTGCTCG
CAATGTGCTCG: AATGTGCTCGA
AATGTGCTCGA: ATGTGCTCGAC
ATGTGCTCGAC: TGTGCTCGACT
TGTGCTCGACT: GTGCTCGACTC
GTGCTCGACTC: TGCTCGACTCT
TGCTCGACTCT: GCTCGACTCTC
GCTCGACTCTC: CTCGACTCTCG
CTCGACTCTCG: TCGACTCTCGA
TCGACTCTCGA: CGACTCTCGAC
CGACTCTCGAC: GACTCTCGACA
GACTCTCGACA: ACTCTCGACAG
ACTCTCGACAG: CTCTCGACAGA
CTCTCGACAGA: TCTCGACAGAG
TCTCGACAGAG: CTCGACAGAGG
CTCGACAGAGG: TCGACAGAGGT
TCGACAGAGGT: CGACAGAGGTA
CGACAGAGGTA: GACAGAGGTAT
GACAGAGGTAT: ACAGAGGTATT
ACAGAGGTATT: CAGAGGTATTA
CAGAGGTATTA: AGAGGTATTAC
AGAGGTATTAC: GAGGTATTACT
GAGGTATTACT: AGGTATTACTA
AGGTATTACTA: GGTATTACTAG
GGTATTACTAG: GTATTACTAGA
GTATTACTAGA: TATTACTAGAG
TATTACTAGAG: ATTACTAGAGG
ATTACTAGAGG: TTACTAGAGGG
TTACTAGAGGG: TACTAGAGGGA
TACTAGAGGGA: ACTAGAGGGAG
ACTAGAGGGAG: CTAGAGGGAGT
CTAGAGGGAGT: TAGAGGGAGTG
TAGAGGGAGTG: AGAGGGAGTGG
AGAGGGAGTGG: GAGGGAGTGGA
GAGGGAGTGGA: AGGGAGTGGAG
AGGGAGTGGAG: GGGAGTGGAGA
GGGAGTGGAGA: GGAGTGGAGAT
GGAGTGGAGAT: GAGTGGAGATA
GAGTGGAGATA: AGTGGAGATAA
AGTGGAGATAA: GTGGAGATAAG
GTGGAGATAAG: TGGAGATAAGA
TGGAGATAAGA: GGAGATAAGAT
GGAGATAAGAT: GAGATAAGATC
GAGATAAGATC: AGATAAGATCG
AGATAAGATCG: GATAAGATCGT
GATAAGATCGT: ATAAGATCGTA
ATAAGATCGTA: TAAGATCGTAA
TAAGATCGTAA: AAGATCGTAAT
AAGATCGTAAT: AGATCGTAATT
AGATCGTAATT: GATCGTAATTG
GATCGTAATTG: ATCGTAATTGG
ATCGTAATTGG: TCGTAATTGGA
TCGTAATTGGA: CGTAATTGGAG
CGTAATTGGAG: GTAATTGGAGC
GTAATTGGAGC: TAATTGGAGCC
TAATTGGAGCC: AATTGGAGCCC
AATTGGAGCCC: ATTGGAGCCCG
ATTGGAGCCCG: TTGGAGCCCGT
TTGGAGCCCGT: TGGAGCCCGTT
TGGAGCCCGTT: GGAGCCCGTTA
GGAGCCCGTTA: GAGCCCGTTAG
GAGCCCGTTAG: AGCCCGTTAGG
AGCCCGTTAGG: GCCCGTTAGGT
GCCCGTTAGGT: CCCGTTAGGTG
CCCGTTAGGTG: CCGTTAGGTGA
CCGTTAGGTGA: CGTTAGGTGAG
CGTTAGGTGAG: GTTAGGTGAGT
GTTAGGTGAGT: TTAGGTGAGTA
TTAGGTGAGTA: TAGGTGAGTAC
TAGGTGAGTAC: AGGTGAGTACA
AGGTGAGTACA: GGTGAGTACAC
GGTGAGTACAC: GTGAGTACACA
GTGAGTACACA: TGAGTACACAA
TGAGTACACAA: GAGTACACAAA
GAGTACACAAA: AGTACACAAAT
AGTACACAAAT: GTACACAAATG
GTACACAAATG: TACACAAATGT
TACACAAATGT: ACACAAATGTA
ACACAAATGTA: CACAAATGTAA
CACAAATGTAA: ACAAATGTAAT
ACAAATGTAAT: CAAATGTAATT
CAAATGTAATT: AAATGTAATTC
AAATGTAATTC: AATGTAATTCG
AATGTAATTCG: ATGTAATTCGG
ATGTAATTCGG: TGTAATTCGGG
TGTAATTCGGG: GTAATTCGGGT
GTAATTCGGGT: TAATTCGGGTA
TAATTCGGGTA: AATTCGGGTAT
AATTCGGGTAT: ATTCGGGTATT
ATTCGGGTATT: TTCGGGTATTA
TTCGGGTATTA: TCGGGTATTAA
TCGGGTATTAA: CGGGTATTAAA
CGGGTATTAAA: GGGTATTAAAC
GGGTATTAAAC: GGTATTAAACT
GGTATTAAACT: GTATTAAACTA
GTATTAAACTA: TATTAAACTAC
TATTAAACTAC: ATTAAACTACG
ATTAAACTACG: TTAAACTACGA
TTAAACTACGA: TAAACTACGAG
TAAACTACGAG: AAACTACGAGC
AAACTACGAGC: AACTACGAGCT
AACTACGAGCT: ACTACGAGCTA
ACTACGAGCTA: CTACGAGCTAC
CTACGAGCTAC: TACGAGCTACC
TACGAGCTACC: ACGAGCTACCG
ACGAGCTACCG: CGAGCTACCGA
CGAGCTACCGA: GAGCTACCGAT
GAGCTACCGAT: AGCTACCGATT
AGCTACCGATT: GCTACCGATTC
GCTACCGATTC: CTACCGATTCA
CTACCGATTCA: TACCGATTCAC
TACCGATTCAC: ACCGATTCACA
ACCGATTCACA: CCGATTCACAA
CCGATTCACAA: CGATTCACAAG
CGATTCACAAG: GATTCACAAGA
GATTCACAAGA: ATTCACAAGAA
ATTCACAAGAA: TTCACAAGAAG
TTCACAAGAAG: TCACAAGAAGT
TCACAAGAAGT: CACAAGAAGTG
CACAAGAAGTG: ACAAGAAGTGA
ACAAGAAGTGA: CAAGAAGTGAT
CAAGAAGTGAT: AAGAAGTGATA
AAGAAGTGATA: AGAAGTGATAA
AGAAGTGATAA: GAAGTGATAAT
GAAGTGATAAT: AAGTGATAATA
AAGTGATAATA: AGTGATAATAC
AGTGATAATAC: GTGATAATACA
GTGATAATACA: TGATAATACAG
TGATAATACAG: GATAATACAGC
GATAATACAGC: ATAATACAGCA
ATAATACAGCA: TAATACAGCAG
TAATACAGCAG: AATACAGCAGA
AATACAGCAGA: ATACAGCAGAT
ATACAGCAGAT: TACAGCAGATG
TACAGCAGATG: ACAGCAGATGC
ACAGCAGATGC: CAGCAGATGCG
CAGCAGATGCG: AGCAGATGCGG
AGCAGATGCGG: GCAGATGCGGC
GCAGATGCGGC: CAGATGCGGCA
CAGATGCGGCA: AGATGCGGCAG
AGATGCGGCAG: GATGCGGCAGG
GATGCGGCAGG: ATGCGGCAGGA
ATGCGGCAGGA: TGCGGCAGGAG
TGCGGCAGGAG: GCGGCAGGAGA
GCGGCAGGAGA: CGGCAGGAGAA
CGGCAGGAGAA: GGCAGGAGAAA
GGCAGGAGAAA: GCAGGAGAAAT
GCAGGAGAAAT: CAGGAGAAATA
CAGGAGAAATA: AGGAGAAATAC
AGGAGAAATAC: GGAGAAATACA
GGAGAAATACA: GAGAAATACAA
GAGAAATACAA: AGAAATACAAA
AGAAATACAAA: GAAATACAAAG
GAAATACAAAG: AAATACAAAGC
AAATACAAAGC: AATACAAAGCG
AATACAAAGCG: ATACAAAGCGT
ATACAAAGCGT: TACAAAGCGTA
TACAAAGCGTA: ACAAAGCGTAT
ACAAAGCGTAT: CAAAGCGTATC
CAAAGCGTATC: AAAGCGTATCA
AAAGCGTATCA: AAGCGTATCAC
AAGCGTATCAC: AGCGTATCACA
AGCGTATCACA: GCGTATCACAA
GCGTATCACAA: CGTATCACAAC
CGTATCACAAC: GTATCACAACA
GTATCACAACA: TATCACAACAG
TATCACAACAG: ATCACAACAGG
ATCACAACAGG: TCACAACAGGT
TCACAACAGGT: CACAACAGGTG
CACAACAGGTG: ACAACAGGTGC
ACAACAGGTGC: CAACAGGTGCA
CAACAGGTGCA: AACAGGTGCAT
AACAGGTGCAT: ACAGGTGCATT
ACAGGTGCATT: CAGGTGCATTG
CAGGTGCATTG: AGGTGCATTGA
AGGTGCATTGA: GGTGCATTGAG
GGTGCATTGAG: GTGCATTGAGC
GTGCATTGAGC: TGCATTGAGCT
TGCATTGAGCT: GCATTGAGCTA
GCATTGAGCTA: CATTGAGCTAT
CATTGAGCTAT: ATTGAGCTATG
ATTGAGCTATG: TTGAGCTATGA
TTGAGCTATGA: TGAGCTATGAA
TGAGCTATGAA: GAGCTATGAAT
GAGCTATGAAT: AGCTATGAATT
AGCTATGAATT: GCTATGAATTA
GCTATGAATTA: CTATGAATTAT
CTATGAATTAT: TATGAATTATC
TATGAATTATC: ATGAATTATCC
ATGAATTATCC: TGAATTATCCA
TGAATTATCCA: GAATTATCCAT
GAATTATCCAT: AATTATCCATA
AATTATCCATA: ATTATCCATAT
ATTATCCATAT: TTATCCATATA
TTATCCATATA: TATCCATATAA
TATCCATATAA: ATCCATATAAG
ATCCATATAAG: TCCATATAAGA
TCCATATAAGA: CCATATAAGAC
CCATATAAGAC: CATATAAGACT
CATATAAGACT: ATATAAGACTC
ATATAAGACTC: TATAAGACTCG
TATAAGACTCG: ATAAGACTCGC
ATAAGACTCGC: TAAGACTCGCC
TAAGACTCGCC: AAGACTCGCCG
AAGACTCGCCG: AGACTCGCCGC
AGACTCGCCGC: GACTCGCCGCT
GACTCGCCGCT: ACTCGCCGCTT
ACTCGCCGCTT: CTCGCCGCTTA
CTCGCCGCTTA: TCGCCGCTTAA
TCGCCGCTTAA: CGCCGCTTAAA
CGCCGCTTAAA: GCCGCTTAAAA
GCCGCTTAAAA: CCGCTTAAAAA
CCGCTTAAAAA: CGCTTAAAAAA
CGCTTAAAAAA: GCTTAAAAAAG
GCTTAAAAAAG: CTTAAAAAAGT
CTTAAAAAAGT: TTAAAAAAGTG
TTAAAAAAGTG: TAAAAAAGTGA
TAAAAAAGTGA: AAAAAAGTGAT
AAAAAAGTGAT: AAAAAGTGATA
AAAAAGTGATA: AAAAGTGATAC
AAAAGTGATAC: AAAGTGATACA
AAAGTGATACA: AAGTGATACAA
AAGTGATACAA: AGTGATACAAA
AGTGATACAAA: GTGATACAAAG
GTGATACAAAG: TGATACAAAGC
TGATACAAAGC: GATACAAAGCA
GATACAAAGCA: ATACAAAGCAC
ATACAAAGCAC: TACAAAGCACT
TACAAAGCACT: ACAAAGCACTA
ACAAAGCACTA: CAAAGCACTAG
CAAAGCACTAG: AAAGCACTAGG
AAAGCACTAGG: AAGCACTAGGT
AAGCACTAGGT: AGCACTAGGTT
AGCACTAGGTT: GCACTAGGTTC
GCACTAGGTTC: CACTAGGTTCT
CACTAGGTTCT: ACTAGGTTCTC
ACTAGGTTCTC: CTAGGTTCTCG
CTAGGTTCTCG: TAGGTTCTCGT
TAGGTTCTCGT: AGGTTCTCGTG
AGGTTCTCGTG: GGTTCTCGTGA
GGTTCTCGTGA: GTTCTCGTGAT
GTTCTCGTGAT: TTCTCGTGATG
TTCTCGTGATG: TCTCGTGATGA
TCTCGTGATGA: CTCGTGATGAG
CTCGTGATGAG: TCGTGATGAGT
TCGTGATGAGT: CGTGATGAGTT
CGTGATGAGTT: GTGATGAGTTT
GTGATGAGTTT: TGATGAGTTTG
TGATGAGTTTG: GATGAGTTTGA
GATGAGTTTGA: ATGAGTTTGAT
ATGAGTTTGAT: TGAGTTTGATT
TGAGTTTGATT: GAGTTTGATTA
GAGTTTGATTA: AGTTTGATTAT
AGTTTGATTAT: GTTTGATTATC
GTTTGATTATC: TTTGATTATCC
TTTGATTATCC: TTGATTATCCA
TTGATTATCCA: TGATTATCCAT
TGATTATCCAT: GATTATCCATC
GATTATCCATC: ATTATCCATCA
ATTATCCATCA: TTATCCATCAG
TTATCCATCAG: TATCCATCAGG
TATCCATCAGG: ATCCATCAGGA
ATCCATCAGGA: TCCATCAGGAA
TCCATCAGGAA: CCATCAGGAAC
CCATCAGGAAC: CATCAGGAACC
CATCAGGAACC: ATCAGGAACCT
ATCAGGAACCT: TCAGGAACCTT
TCAGGAACCTT: CAGGAACCTTC
CAGGAACCTTC: AGGAACCTTCC
AGGAACCTTCC: GGAACCTTCCC
GGAACCTTCCC: GAACCTTCCCT
GAACCTTCCCT: AACCTTCCCTT
AACCTTCCCTT: ACCTTCCCTTG
ACCTTCCCTTG: CCTTCCCTTGA
CCTTCCCTTGA: CTTCCCTTGAC
CTTCCCTTGAC: TTCCCTTGACA
TTCCCTTGACA: TCCCTTGACAA
TCCCTTGACAA: CCCTTGACAAA
CCCTTGACAAA: CCTTGACAAAG
CCTTGACAAAG: CTTGACAAAGG
CTTGACAAAGG: TTGACAAAGGT
TTGACAAAGGT: TGACAAAGGTT
TGACAAAGGTT: GACAAAGGTTG
GACAAAGGTTG: ACAAAGGTTGG
ACAAAGGTTGG: CAAAGGTTGGA
CAAAGGTTGGA: AAAGGTTGGAT
AAAGGTTGGAT: AAGGTTGGATG
AAGGTTGGATG: AGGTTGGATGC
AGGTTGGATGC: GGTTGGATGCA
GGTTGGATGCA: GTTGGATGCAA
GTTGGATGCAA: TTGGATGCAAT
TTGGATGCAAT: TGGATGCAATT
TGGATGCAATT: GGATGCAATTA
GGATGCAATTA: GATGCAATTAG
GATGCAATTAG: ATGCAATTAGT
ATGCAATTAGT: TGCAATTAGTC
TGCAATTAGTC: GCAATTAGTCG
GCAATTAGTCG: CAATTAGTCGC
CAATTAGTCGC: AATTAGTCGCG
AATTAGTCGCG: ATTAGTCGCGC
ATTAGTCGCGC: TTAGTCGCGCC
TTAGTCGCGCC: TAGTCGCGCCG
TAGTCGCGCCG: AGTCGCGCCGT
AGTCGCGCCGT: GTCGCGCCGTA
GTCGCGCCGTA: TCGCGCCGTAG
TCGCGCCGTAG: CGCGCCGTAGG
CGCGCCGTAGG: GCGCCGTAGGC
GCGCCGTAGGC: CGCCGTAGGCG
CGCCGTAGGCG: GCCGTAGGCGA
GCCGTAGGCGA: CCGTAGGCGAA
CCGTAGGCGAA: CGTAGGCGAAC
CGTAGGCGAAC: GTAGGCGAACC
GTAGGCGAACC: TAGGCGAACCG
TAGGCGAACCG: AGGCGAACCGA
AGGCGAACCGA: GGCGAACCGAA
GGCGAACCGAA: GCGAACCGAAT
GCGAACCGAAT: CGAACCGAATA
CGAACCGAATA: GAACCGAATAG
GAACCGAATAG: AACCGAATAGT
AACCGAATAGT: ACCGAATAGTT
ACCGAATAGTT: CCGAATAGTTC
CCGAATAGTTC: CGAATAGTTCC
CGAATAGTTCC: GAATAGTTCCC
GAATAGTTCCC: AATAGTTCCCT
AATAGTTCCCT: ATAGTTCCCTC
ATAGTTCCCTC: TAGTTCCCTCT
TAGTTCCCTCT: AGTTCCCTCTG
AGTTCCCTCTG: GTTCCCTCTGG
GTTCCCTCTGG: TTCCCTCTGGT
TTCCCTCTGGT: TCCCTCTGGTT
TCCCTCTGGTT: CCCTCTGGTTC
CCCTCTGGTTC: CCTCTGGTTCT
CCTCTGGTTCT: CTCTGGTTCTA
CTCTGGTTCTA: TCTGGTTCTAG
TCTGGTTCTAG: CTGGTTCTAGT
CTGGTTCTAGT: TGGTTCTAGTG
TGGTTCTAGTG: GGTTCTAGTGA
GGTTCTAGTGA: GTTCTAGTGAT
GTTCTAGTGAT: TTCTAGTGATC
TTCTAGTGATC: TCTAGTGATCC
TCTAGTGATCC: CTAGTGATCCT
CTAGTGATCCT: TAGTGATCCTT
TAGTGATCCTT: AGTGATCCTTG
AGTGATCCTTG: GTGATCCTTGG
GTGATCCTTGG: TGATCCTTGGG
TGATCCTTGGG: GATCCTTGGGG
GATCCTTGGGG: ATCCTTGGGGT
ATCCTTGGGGT: TCCTTGGGGTC
TCCTTGGGGTC: CCTTGGGGTCG
CCTTGGGGTCG: CTTGGGGTCGC
CTTGGGGTCGC: TTGGGGTCGCG
TTGGGGTCGCG: TGGGGTCGCGG
TGGGGTCGCGG: GGGGTCGCGGT
GGGGTCGCGGT: GGGTCGCGGTT
GGGTCGCGGTT: GGTCGCGGTTA
GGTCGCGGTTA: GTCGCGGTTAG
GTCGCGGTTAG: TCGCGGTTAGA
TCGCGGTTAGA: CGCGGTTAGAC
CGCGGTTAGAC: GCGGTTAGACG
GCGGTTAGACG: CGGTTAGACGG
CGGTTAGACGG: GGTTAGACGGG
GGTTAGACGGG: GTTAGACGGGA
GTTAGACGGGA: TTAGACGGGAC
TTAGACGGGAC: TAGACGGGACA
TAGACGGGACA: AGACGGGACAT
AGACGGGACAT: GACGGGACATT
GACGGGACATT: ACGGGACATTA
ACGGGACATTA: CGGGACATTAA
CGGGACATTAA: GGGACATTAAG
GGGACATTAAG: GGACATTAAGG
GGACATTAAGG: GACATTAAGGG
GACATTAAGGG: ACATTAAGGGA
ACATTAAGGGA: CATTAAGGGAA
CATTAAGGGAA: ATTAAGGGAAC
ATTAAGGGAAC: TTAAGGGAACT
TTAAGGGAACT: TAAGGGAACTG
TAAGGGAACTG: AAGGGAACTGG
AAGGGAACTGG: AGGGAACTGGG
AGGGAACTGGG: GGGAACTGGGC
GGGAACTGGGC: GGAACTGGGCT
GGAACTGGGCT: GAACTGGGCTC
GAACTGGGCTC: AACTGGGCTCG
AACTGGGCTCG: ACTGGGCTCGC
ACTGGGCTCGC: CTGGGCTCGCT
CTGGGCTCGCT: TGGGCTCGCTA
TGGGCTCGCTA: GGGCTCGCTAT
GGGCTCGCTAT: GGCTCGCTATT
GGCTCGCTATT: GCTCGCTATTT
GCTCGCTATTT: CTCGCTATTTG
CTCGCTATTTG: TCGCTATTTGG
TCGCTATTTGG: CGCTATTTGGC
CGCTATTTGGC: GCTATTTGGCT
GCTATTTGGCT: CTATTTGGCTA
CTATTTGGCTA: TATTTGGCTAG
TATTTGGCTAG: ATTTGGCTAGA
ATTTGGCTAGA: TTTGGCTAGAT
TTTGGCTAGAT: TTGGCTAGATG
TTGGCTAGATG: TGGCTAGATGT
TGGCTAGATGT: GGCTAGATGTG
GGCTAGATGTG: GCTAGATGTGG
GCTAGATGTGG: CTAGATGTGGC
CTAGATGTGGC: TAGATGTGGCT
TAGATGTGGCT: AGATGTGGCTT
AGATGTGGCTT: GATGTGGCTTG
GATGTGGCTTG: ATGTGGCTTGA
ATGTGGCTTGA: TGTGGCTTGAC
TGTGGCTTGAC: GTGGCTTGACA
GTGGCTTGACA: TGGCTTGACAA
TGGCTTGACAA: GGCTTGACAAT
GGCTTGACAAT: GCTTGACAATT
GCTTGACAATT: CTTGACAATTG
CTTGACAATTG: TTGACAATTGA
TTGACAATTGA: TGACAATTGAG
TGACAATTGAG: GACAATTGAGC
GACAATTGAGC: ACAATTGAGCT
ACAATTGAGCT: CAATTGAGCTG
CAATTGAGCTG: AATTGAGCTGG
AATTGAGCTGG: ATTGAGCTGGA
ATTGAGCTGGA: TTGAGCTGGAT
TTGAGCTGGAT: TGAGCTGGATG
TGAGCTGGATG: GAGCTGGATGC
GAGCTGGATGC: AGCTGGATGCC
AGCTGGATGCC: GCTGGATGCCT
GCTGGATGCCT: CTGGATGCCTA
CTGGATGCCTA: TGGATGCCTAC
TGGATGCCTAC: GGATGCCTACT
GGATGCCTACT: GATGCCTACTA
GATGCCTACTA: ATGCCTACTAG
ATGCCTACTAG: TGCCTACTAGT
TGCCTACTAGT: GCCTACTAGTT
GCCTACTAGTT: CCTACTAGTTA
CCTACTAGTTA: CTACTAGTTAT
CTACTAGTTAT: TACTAGTTATT
TACTAGTTATT: ACTAGTTATTA
ACTAGTTATTA: CTAGTTATTAA
CTAGTTATTAA: TAGTTATTAAG
TAGTTATTAAG: AGTTATTAAGT
AGTTATTAAGT: GTTATTAAGTT
GTTATTAAGTT: TTATTAAGTTA
TTATTAAGTTA: TATTAAGTTAC
TATTAAGTTAC: ATTAAGTTACT
ATTAAGTTACT: TTAAGTTACTT
TTAAGTTACTT: TAAGTTACTTT
TAAGTTACTTT: AAGTTACTTTT
AAGTTACTTTT: AGTTACTTTTG
AGTTACTTTTG: GTTACTTTTGA
GTTACTTTTGA: TTACTTTTGAT
TTACTTTTGAT: TACTTTTGATT
TACTTTTGATT: ACTTTTGATTC
ACTTTTGATTC: CTTTTGATTCT
CTTTTGATTCT: TTTTGATTCTC
TTTTGATTCTC: TTTGATTCTCT
TTTGATTCTCT: TTGATTCTCTC
TTGATTCTCTC: TGATTCTCTCT
TGATTCTCTCT: GATTCTCTCTA
GATTCTCTCTA: ATTCTCTCTAG
ATTCTCTCTAG: TTCTCTCTAGG
TTCTCTCTAGG: TCTCTCTAGGG
TCTCTCTAGGG: CTCTCTAGGGG
CTCTCTAGGGG: TCTCTAGGGGT
TCTCTAGGGGT: CTCTAGGGGTA
CTCTAGGGGTA: TCTAGGGGTAG
TCTAGGGGTAG: CTAGGGGTAGG
CTAGGGGTAGG: TAGGGGTAGGC
TAGGGGTAGGC: AGGGGTAGGCC
AGGGGTAGGCC: GGGGTAGGCCT
GGGGTAGGCCT: GGGTAGGCCTT
GGGTAGGCCTT: GGTAGGCCTTT
GGTAGGCCTTT: GTAGGCCTTTC
GTAGGCCTTTC: TAGGCCTTTCA
TAGGCCTTTCA: AGGCCTTTCAC
AGGCCTTTCAC: GGCCTTTCACA
GGCCTTTCACA: GCCTTTCACAG
GCCTTTCACAG: CCTTTCACAGA
CCTTTCACAGA: CTTTCACAGAC
CTTTCACAGAC: TTTCACAGACG
TTTCACAGACG: TTCACAGACGG
TTCACAGACGG: TCACAGACGGT
TCACAGACGGT: CACAGACGGTG
CACAGACGGTG: ACAGACGGTGC
ACAGACGGTGC: CAGACGGTGCA
CAGACGGTGCA: AGACGGTGCAA
AGACGGTGCAA: GACGGTGCAAG
GACGGTGCAAG: ACGGTGCAAGA
ACGGTGCAAGA: CGGTGCAAGAA
CGGTGCAAGAA: GGTGCAAGAAG
GGTGCAAGAAG: GTGCAAGAAGC
GTGCAAGAAGC: TGCAAGAAGCC
TGCAAGAAGCC: GCAAGAAGCCC
GCAAGAAGCCC: CAAGAAGCCCA
CAAGAAGCCCA: AAGAAGCCCAC
AAGAAGCCCAC: AGAAGCCCACC
AGAAGCCCACC: GAAGCCCACCC
GAAGCCCACCC: AAGCCCACCCT
AAGCCCACCCT: AGCCCACCCTG
AGCCCACCCTG: GCCCACCCTGT
GCCCACCCTGT: CCCACCCTGTA
CCCACCCTGTA: CCACCCTGTAA
CCACCCTGTAA: CACCCTGTAAG
CACCCTGTAAG: ACCCTGTAAGC
ACCCTGTAAGC: CCCTGTAAGCG
CCCTGTAAGCG: CCTGTAAGCGA
CCTGTAAGCGA: CTGTAAGCGAT
CTGTAAGCGAT: TGTAAGCGATC
TGTAAGCGATC: GTAAGCGATCG
GTAAGCGATCG: TAAGCGATCGC
TAAGCGATCGC: AAGCGATCGCC
AAGCGATCGCC: AGCGATCGCCC
AGCGATCGCCC: GCGATCGCCCG
GCGATCGCCCG: CGATCGCCCGT
CGATCGCCCGT: GATCGCCCGTA
GATCGCCCGTA: ATCGCCCGTAA
ATCGCCCGTAA: TCGCCCGTAAG
TCGCCCGTAAG: CGCCCGTAAGG
CGCCCGTAAGG: GCCCGTAAGGA
GCCCGTAAGGA: CCCGTAAGGAA
CCCGTAAGGAA: CCGTAAGGAAA
CCGTAAGGAAA: CGTAAGGAAAC
CGTAAGGAAAC: GTAAGGAAACA
GTAAGGAAACA: TAAGGAAACAG
TAAGGAAACAG: AAGGAAACAGG
AAGGAAACAGG: AGGAAACAGGG
AGGAAACAGGG: GGAAACAGGGG
GGAAACAGGGG: GAAACAGGGGC
GAAACAGGGGC: AAACAGGGGCA
AAACAGGGGCA: AACAGGGGCAG
AACAGGGGCAG: ACAGGGGCAGC
ACAGGGGCAGC: CAGGGGCAGCG
CAGGGGCAGCG: AGGGGCAGCGA
AGGGGCAGCGA: GGGGCAGCGAT
GGGGCAGCGAT: GGGCAGCGATT
GGGCAGCGATT: GGCAGCGATTT
GGCAGCGATTT: GCAGCGATTTG
GCAGCGATTTG: CAGCGATTTGG
CAGCGATTTGG: AGCGATTTGGC
AGCGATTTGGC: GCGATTTGGCT
GCGATTTGGCT: CGATTTGGCTC
CGATTTGGCTC: GATTTGGCTCC
GATTTGGCTCC: ATTTGGCTCCC
ATTTGGCTCCC: TTTGGCTCCCT
TTTGGCTCCCT: TTGGCTCCCTA
TTGGCTCCCTA: TGGCTCCCTAT
TGGCTCCCTAT: GGCTCCCTATA
GGCTCCCTATA: GCTCCCTATAC
GCTCCCTATAC: CTCCCTATACT
CTCCCTATACT: TCCCTATACTG
TCCCTATACTG: CCCTATACTGT
CCCTATACTGT: CCTATACTGTT
CCTATACTGTT: CTATACTGTTC
CTATACTGTTC: TATACTGTTCT
TATACTGTTCT: ATACTGTTCTA
ATACTGTTCTA: TACTGTTCTAG
TACTGTTCTAG: ACTGTTCTAGC
ACTGTTCTAGC: CTGTTCTAGCG
CTGTTCTAGCG: TGTTCTAGCGG
TGTTCTAGCGG: GTTCTAGCGGC
GTTCTAGCGGC: TTCTAGCGGCC
TTCTAGCGGCC: TCTAGCGGCCG
TCTAGCGGCCG: CTAGCGGCCGC
CTAGCGGCCGC: TAGCGGCCGCT
TAGCGGCCGCT: AGCGGCCGCTG
AGCGGCCGCTG: GCGGCCGCTGC
GCGGCCGCTGC: CGGCCGCTGCT
CGGCCGCTGCT: GGCCGCTGCTC
GGCCGCTGCTC: GCCGCTGCTCT
GCCGCTGCTCT: CCGCTGCTCTA
CCGCTGCTCTA: CGCTGCTCTAT
CGCTGCTCTAT: GCTGCTCTATT
GCTGCTCTATT: CTGCTCTATTA
CTGCTCTATTA: TGCTCTATTAG
TGCTCTATTAG: GCTCTATTAGC
GCTCTATTAGC: CTCTATTAGCC
CTCTATTAGCC: TCTATTAGCCT
TCTATTAGCCT: CTATTAGCCTC
CTATTAGCCTC: TATTAGCCTCG
TATTAGCCTCG: ATTAGCCTCGA
ATTAGCCTCGA: TTAGCCTCGAG
TTAGCCTCGAG: TAGCCTCGAGA
TAGCCTCGAGA: AGCCTCGAGAC
AGCCTCGAGAC: GCCTCGAGACG
GCCTCGAGACG: CCTCGAGACGT
CCTCGAGACGT: CTCGAGACGTT
CTCGAGACGTT: TCGAGACGTTT
TCGAGACGTTT: CGAGACGTTTG
CGAGACGTTTG: GAGACGTTTGC
GAGACGTTTGC: AGACGTTTGCT
AGACGTTTGCT: GACGTTTGCTC
GACGTTTGCTC: ACGTTTGCTCC
ACGTTTGCTCC: CGTTTGCTCCG
CGTTTGCTCCG: GTTTGCTCCGA
GTTTGCTCCGA: TTTGCTCCGAG
TTTGCTCCGAG: TTGCTCCGAGT
TTGCTCCGAGT: TGCTCCGAGTC
TGCTCCGAGTC: GCTCCGAGTCC
GCTCCGAGTCC: CTCCGAGTCCG
CTCCGAGTCCG: TCCGAGTCCGC
TCCGAGTCCGC: CCGAGTCCGCC
CCGAGTCCGCC: CGAGTCCGCCT
CGAGTCCGCCT: GAGTCCGCCTA
GAGTCCGCCTA: AGTCCGCCTAA
AGTCCGCCTAA: GTCCGCCTAAG
GTCCGCCTAAG: TCCGCCTAAGG
TCCGCCTAAGG: CCGCCTAAGGA
CCGCCTAAGGA: CGCCTAAGGAG
CGCCTAAGGAG: GCCTAAGGAGC
GCCTAAGGAGC: CCTAAGGAGCC
CCTAAGGAGCC: CTAAGGAGCCA
CTAAGGAGCCA: TAAGGAGCCAT
TAAGGAGCCAT: AAGGAGCCATT
AAGGAGCCATT: AGGAGCCATTA
AGGAGCCATTA: GGAGCCATTAG
GGAGCCATTAG: GAGCCATTAGA
GAGCCATTAGA: AGCCATTAGAC
AGCCATTAGAC: GCCATTAGACC
GCCATTAGACC: CCATTAGACCT
CCATTAGACCT: CATTAGACCTG
CATTAGACCTG: ATTAGACCTGC
ATTAGACCTGC: TTAGACCTGCA
TTAGACCTGCA: TAGACCTGCAT
TAGACCTGCAT: AGACCTGCATG
AGACCTGCATG: GACCTGCATGT
GACCTGCATGT: ACCTGCATGTA
ACCTGCATGTA: CCTGCATGTAA
CCTGCATGTAA: CTGCATGTAAA
CTGCATGTAAA: TGCATGTAAAG
TGCATGTAAAG: GCATGTAAAGA
GCATGTAAAGA: CATGTAAAGAA
CATGTAAAGAA: ATGTAAAGAAC
ATGTAAAGAAC: TGTAAAGAACG
TGTAAAGAACG: GTAAAGAACGC
GTAAAGAACGC: TAAAGAACGCT
TAAAGAACGCT: AAAGAACGCTC
AAAGAACGCTC: AAGAACGCTCT
AAGAACGCTCT: AGAACGCTCTC
AGAACGCTCTC: GAACGCTCTCT
GAACGCTCTCT: AACGCTCTCTT
AACGCTCTCTT: ACGCTCTCTTC
ACGCTCTCTTC: CGCTCTCTTCG
CGCTCTCTTCG: GCTCTCTTCGT
GCTCTCTTCGT: CTCTCTTCGTC
CTCTCTTCGTC: TCTCTTCGTCA
TCTCTTCGTCA: CTCTTCGTCAA
CTCTTCGTCAA: TCTTCGTCAAG
TCTTCGTCAAG: CTTCGTCAAGA
CTTCGTCAAGA: TTCGTCAAGAC
TTCGTCAAGAC: TCGTCAAGACG
TCGTCAAGACG: CGTCAAGACGT
CGTCAAGACGT: GTCAAGACGTC
GTCAAGACGTC: TCAAGACGTCA
TCAAGACGTCA: CAAGACGTCAT
CAAGACGTCAT: AAGACGTCATC
AAGACGTCATC: AGACGTCATCG
AGACGTCATCG: GACGTCATCGT
GACGTCATCGT: ACGTCATCGTA
ACGTCATCGTA: CGTCATCGTAA
CGTCATCGTAA: GTCATCGTAAG
GTCATCGTAAG: TCATCGTAAGC
TCATCGTAAGC: CATCGTAAGCA
CATCGTAAGCA: ATCGTAAGCAC
ATCGTAAGCAC: TCGTAAGCACG
TCGTAAGCACG: CGTAAGCACGT
CGTAAGCACGT: GTAAGCACGTG
GTAAGCACGTG: TAAGCACGTGG
TAAGCACGTGG: AAGCACGTGGC
AAGCACGTGGC: AGCACGTGGCA
AGCACGTGGCA: GCACGTGGCAG
GCACGTGGCAG: CACGTGGCAGT
CACGTGGCAGT: ACGTGGCAGTC
ACGTGGCAGTC: CGTGGCAGTCG
CGTGGCAGTCG: GTGGCAGTCGG
GTGGCAGTCGG: TGGCAGTCGGC
TGGCAGTCGGC: GGCAGTCGGCG
GGCAGTCGGCG: GCAGTCGGCGT
GCAGTCGGCGT: CAGTCGGCGTT
CAGTCGGCGTT: AGTCGGCGTTA
AGTCGGCGTTA: GTCGGCGTTAC
GTCGGCGTTAC: TCGGCGTTACT
TCGGCGTTACT: CGGCGTTACTC
CGGCGTTACTC: GGCGTTACTCG
GGCGTTACTCG: GCGTTACTCGC
GCGTTACTCGC: CGTTACTCGCA
CGTTACTCGCA: GTTACTCGCAC
GTTACTCGCAC: TTACTCGCACC
TTACTCGCACC: TACTCGCACCG
TACTCGCACCG: ACTCGCACCGG
ACTCGCACCGG: CTCGCACCGGC
CTCGCACCGGC: TCGCACCGGCA
TCGCACCGGCA: CGCACCGGCAG
CGCACCGGCAG: GCACCGGCAGA
GCACCGGCAGA: CACCGGCAGAG
CACCGGCAGAG: ACCGGCAGAGA
ACCGGCAGAGA: CCGGCAGAGAT
CCGGCAGAGAT: CGGCAGAGATG
CGGCAGAGATG: GGCAGAGATGG
GGCAGAGATGG: GCAGAGATGGC
GCAGAGATGGC: CAGAGATGGCT
CAGAGATGGCT: AGAGATGGCTT
AGAGATGGCTT: GAGATGGCTTT
GAGATGGCTTT: AGATGGCTTTG
AGATGGCTTTG: GATGGCTTTGC
GATGGCTTTGC: ATGGCTTTGCC
ATGGCTTTGCC: TGGCTTTGCCG
TGGCTTTGCCG: GGCTTTGCCGG
GGCTTTGCCGG: GCTTTGCCGGT
GCTTTGCCGGT: CTTTGCCGGTA
CTTTGCCGGTA: TTTGCCGGTAG
TTTGCCGGTAG: TTGCCGGTAGT
TTGCCGGTAGT: TGCCGGTAGTA
TGCCGGTAGTA: GCCGGTAGTAT
GCCGGTAGTAT: CCGGTAGTATA
CCGGTAGTATA: CGGTAGTATAT
CGGTAGTATAT: GGTAGTATATC
GGTAGTATATC: GTAGTATATCT
GTAGTATATCT: TAGTATATCTG
TAGTATATCTG: AGTATATCTGG
AGTATATCTGG: GTATATCTGGC
GTATATCTGGC: TATATCTGGCA
TATATCTGGCA: ATATCTGGCAT
ATATCTGGCAT: TATCTGGCATT
TATCTGGCATT: ATCTGGCATTT
ATCTGGCATTT: TCTGGCATTTC
TCTGGCATTTC: CTGGCATTTCC
CTGGCATTTCC: TGGCATTTCCT
TGGCATTTCCT: GGCATTTCCTC
GGCATTTCCTC: GCATTTCCTCA
GCATTTCCTCA: CATTTCCTCAA
CATTTCCTCAA: ATTTCCTCAAC
ATTTCCTCAAC: TTTCCTCAACG
TTTCCTCAACG: TTCCTCAACGA
TTCCTCAACGA: TCCTCAACGAG
TCCTCAACGAG: CCTCAACGAGC
CCTCAACGAGC: CTCAACGAGCC
CTCAACGAGCC: TCAACGAGCCC
TCAACGAGCCC: CAACGAGCCCC
CAACGAGCCCC: AACGAGCCCCA
AACGAGCCCCA: ACGAGCCCCAA
ACGAGCCCCAA: CGAGCCCCAAG
CGAGCCCCAAG: GAGCCCCAAGT
GAGCCCCAAGT: AGCCCCAAGTC
AGCCCCAAGTC: GCCCCAAGTCC
GCCCCAAGTCC: CCCCAAGTCCG
CCCCAAGTCCG: CCCAAGTCCGC
CCCAAGTCCGC: CCAAGTCCGCC
CCAAGTCCGCC: CAAGTCCGCCA
CAAGTCCGCCA: AAGTCCGCCAA
AAGTCCGCCAA: AGTCCGCCAAT
AGTCCGCCAAT: GTCCGCCAATT
GTCCGCCAATT: TCCGCCAATTT
TCCGCCAATTT: CCGCCAATTTT
CCGCCAATTTT: CGCCAATTTTG
CGCCAATTTTG: GCCAATTTTGG
GCCAATTTTGG: CCAATTTTGGA
CCAATTTTGGA: CAATTTTGGAT
CAATTTTGGAT: AATTTTGGATC
AATTTTGGATC: ATTTTGGATCG
ATTTTGGATCG: TTTTGGATCGC
TTTTGGATCGC: TTTGGATCGCG
TTTGGATCGCG: TTGGATCGCGG
TTGGATCGCGG: TGGATCGCGGG
TGGATCGCGGG: GGATCGCGGGA
GGATCGCGGGA: GATCGCGGGAA
GATCGCGGGAA: ATCGCGGGAAT
ATCGCGGGAAT: TCGCGGGAATG
TCGCGGGAATG: CGCGGGAATGT
CGCGGGAATGT: GCGGGAATGTC
GCGGGAATGTC: CGGGAATGTCT
CGGGAATGTCT: GGGAATGTCTA
GGGAATGTCTA: GGAATGTCTAG
GGAATGTCTAG: GAATGTCTAGG
GAATGTCTAGG: AATGTCTAGGC
AATGTCTAGGC: ATGTCTAGGCT
ATGTCTAGGCT: TGTCTAGGCTC
TGTCTAGGCTC: GTCTAGGCTCG
GTCTAGGCTCG: TCTAGGCTCGG
TCTAGGCTCGG: CTAGGCTCGGG
CTAGGCTCGGG: TAGGCTCGGGT
TAGGCTCGGGT: AGGCTCGGGTA
AGGCTCGGGTA: GGCTCGGGTAT
GGCTCGGGTAT: GCTCGGGTATG
GCTCGGGTATG: CTCGGGTATGT
CTCGGGTATGT: TCGGGTATGTT
TCGGGTATGTT: CGGGTATGTTG
CGGGTATGTTG: GGGTATGTTGT
GGGTATGTTGT: GGTATGTTGTT
GGTATGTTGTT: GTATGTTGTTG
GTATGTTGTTG: TATGTTGTTGA
TATGTTGTTGA: ATGTTGTTGAT
ATGTTGTTGAT: TGTTGTTGATA
TGTTGTTGATA: GTTGTTGATAA
GTTGTTGATAA: TTGTTGATAAT
TTGTTGATAAT: TGTTGATAATG
TGTTGATAATG: GTTGATAATGT
GTTGATAATGT: TTGATAATGTA
TTGATAATGTA: TGATAATGTAC
TGATAATGTAC: GATAATGTACC
GATAATGTACC: ATAATGTACCT
ATAATGTACCT: TAATGTACCTC
TAATGTACCTC: AATGTACCTCA
AATGTACCTCA: ATGTACCTCAG
ATGTACCTCAG: TGTACCTCAGT
TGTACCTCAGT: GTACCTCAGTT
GTACCTCAGTT: TACCTCAGTTA
TACCTCAGTTA: ACCTCAGTTAG
ACCTCAGTTAG: CCTCAGTTAGT
CCTCAGTTAGT: CTCAGTTAGTC
CTCAGTTAGTC: TCAGTTAGTCG
TCAGTTAGTCG: CAGTTAGTCGT
CAGTTAGTCGT: AGTTAGTCGTT
AGTTAGTCGTT: GTTAGTCGTTG
GTTAGTCGTTG: TTAGTCGTTGT
TTAGTCGTTGT: TAGTCGTTGTC
TAGTCGTTGTC: AGTCGTTGTCA
AGTCGTTGTCA: GTCGTTGTCAC
GTCGTTGTCAC: TCGTTGTCACG
TCGTTGTCACG: CGTTGTCACGC
CGTTGTCACGC: GTTGTCACGCT
GTTGTCACGCT: TTGTCACGCTA
TTGTCACGCTA: TGTCACGCTAA
TGTCACGCTAA: GTCACGCTAAC
GTCACGCTAAC: TCACGCTAACC
TCACGCTAACC: CACGCTAACCG
CACGCTAACCG: ACGCTAACCGG
ACGCTAACCGG: CGCTAACCGGC
CGCTAACCGGC: GCTAACCGGCA
GCTAACCGGCA: CTAACCGGCAG
CTAACCGGCAG: TAACCGGCAGG
TAACCGGCAGG: AACCGGCAGGA
AACCGGCAGGA: ACCGGCAGGAC
ACCGGCAGGAC: CCGGCAGGACT
CCGGCAGGACT: CGGCAGGACTT
CGGCAGGACTT: GGCAGGACTTT
GGCAGGACTTT: GCAGGACTTTA
GCAGGACTTTA: CAGGACTTTAA
CAGGACTTTAA: AGGACTTTAAT
AGGACTTTAAT: GGACTTTAATT
GGACTTTAATT: GACTTTAATTG
GACTTTAATTG: ACTTTAATTGC
ACTTTAATTGC: CTTTAATTGCC
CTTTAATTGCC: TTTAATTGCCT
TTTAATTGCCT: TTAATTGCCTA
TTAATTGCCTA: TAATTGCCTAG
TAATTGCCTAG: AATTGCCTAGC
AATTGCCTAGC: ATTGCCTAGCC
ATTGCCTAGCC: TTGCCTAGCCA
TTGCCTAGCCA: TGCCTAGCCAC
TGCCTAGCCAC: GCCTAGCCACT
GCCTAGCCACT: CCTAGCCACTC
CCTAGCCACTC: CTAGCCACTCT
CTAGCCACTCT: TAGCCACTCTC
TAGCCACTCTC: AGCCACTCTCG
AGCCACTCTCG: GCCACTCTCGA
GCCACTCTCGA: CCACTCTCGAG
CCACTCTCGAG: CACTCTCGAGG
CACTCTCGAGG: ACTCTCGAGGC
ACTCTCGAGGC: CTCTCGAGGCG
CTCTCGAGGCG: TCTCGAGGCGG
TCTCGAGGCGG: CTCGAGGCGGA
CTCGAGGCGGA: TCGAGGCGGAA
TCGAGGCGGAA: CGAGGCGGAAT
CGAGGCGGAAT: GAGGCGGAATA
GAGGCGGAATA: AGGCGGAATAC
AGGCGGAATAC: GGCGGAATACC
GGCGGAATACC: GCGGAATACCA
GCGGAATACCA: CGGAATACCAT
CGGAATACCAT: GGAATACCATC
GGAATACCATC: GAATACCATCA
GAATACCATCA: AATACCATCAA
AATACCATCAA: ATACCATCAAG
ATACCATCAAG: TACCATCAAGT
TACCATCAAGT: ACCATCAAGTC
ACCATCAAGTC: CCATCAAGTCG
CCATCAAGTCG: CATCAAGTCGG
CATCAAGTCGG: ATCAAGTCGGC
ATCAAGTCGGC: TCAAGTCGGCT
TCAAGTCGGCT: CAAGTCGGCTA
CAAGTCGGCTA: AAGTCGGCTAT
AAGTCGGCTAT: AGTCGGCTATT
AGTCGGCTATT: GTCGGCTATTA
GTCGGCTATTA: TCGGCTATTAC
TCGGCTATTAC: CGGCTATTACC
CGGCTATTACC: GGCTATTACCT
GGCTATTACCT: GCTATTACCTC
GCTATTACCTC: CTATTACCTCC
CTATTACCTCC: TATTACCTCCG
TATTACCTCCG: ATTACCTCCGA
ATTACCTCCGA: TTACCTCCGAT
TTACCTCCGAT: TACCTCCGATC
TACCTCCGATC: ACCTCCGATCA
ACCTCCGATCA: CCTCCGATCAA
CCTCCGATCAA: CTCCGATCAAA
CTCCGATCAAA: TCCGATCAAAA
TCCGATCAAAA: CCGATCAAAAT
CCGATCAAAAT: CGATCAAAATA
CGATCAAAATA: GATCAAAATAG
GATCAAAATAG: ATCAAAATAGC
ATCAAAATAGC: TCAAAATAGCA
TCAAAATAGCA: CAAAATAGCAC
CAAAATAGCAC: AAAATAGCACA
AAAATAGCACA: AAATAGCACAA
AAATAGCACAA: AATAGCACAAT
AATAGCACAAT: ATAGCACAATG
ATAGCACAATG: TAGCACAATGT
TAGCACAATGT: AGCACAATGTT
AGCACAATGTT: GCACAATGTTT
GCACAATGTTT: CACAATGTTTA
CACAATGTTTA: ACAATGTTTAT
ACAATGTTTAT: CAATGTTTATA
CAATGTTTATA: AATGTTTATAG
AATGTTTATAG: ATGTTTATAGA
ATGTTTATAGA: TGTTTATAGAC
TGTTTATAGAC: GTTTATAGACT
GTTTATAGACT: TTTATAGACTG
TTTATAGACTG: TTATAGACTGG
TTATAGACTGG: TATAGACTGGA
TATAGACTGGA: ATAGACTGGAT
ATAGACTGGAT: TAGACTGGATG
TAGACTGGATG: AGACTGGATGC
AGACTGGATGC: GACTGGATGCG
GACTGGATGCG: ACTGGATGCGA
ACTGGATGCGA: CTGGATGCGAC
CTGGATGCGAC: TGGATGCGACC
TGGATGCGACC: GGATGCGACCT
GGATGCGACCT: GATGCGACCTC
GATGCGACCTC: ATGCGACCTCA
ATGCGACCTCA: TGCGACCTCAG
TGCGACCTCAG: GCGACCTCAGT
GCGACCTCAGT: CGACCTCAGTA
CGACCTCAGTA: GACCTCAGTAG
GACCTCAGTAG: ACCTCAGTAGG
ACCTCAGTAGG: CCTCAGTAGGA
CCTCAGTAGGA: CTCAGTAGGAG
CTCAGTAGGAG: TCAGTAGGAGC
TCAGTAGGAGC: CAGTAGGAGCC
CAGTAGGAGCC: AGTAGGAGCCA
AGTAGGAGCCA: GTAGGAGCCAC
GTAGGAGCCAC: TAGGAGCCACA
TAGGAGCCACA: AGGAGCCACAG
AGGAGCCACAG: GGAGCCACAGT
GGAGCCACAGT: GAGCCACAGTT
GAGCCACAGTT: AGCCACAGTTG
AGCCACAGTTG: GCCACAGTTGA
GCCACAGTTGA: CCACAGTTGAG
CCACAGTTGAG: CACAGTTGAGC
CACAGTTGAGC: ACAGTTGAGCA
ACAGTTGAGCA: CAGTTGAGCAT
CAGTTGAGCAT: AGTTGAGCATT
AGTTGAGCATT: GTTGAGCATTA
GTTGAGCATTA: TTGAGCATTAG
TTGAGCATTAG: TGAGCATTAGC
TGAGCATTAGC: GAGCATTAGCT
GAGCATTAGCT: AGCATTAGCTA
AGCATTAGCTA: GCATTAGCTAC
GCATTAGCTAC: CATTAGCTACG
CATTAGCTACG: ATTAGCTACGC
ATTAGCTACGC: TTAGCTACGCC
TTAGCTACGCC: TAGCTACGCCC
TAGCTACGCCC: AGCTACGCCCT
AGCTACGCCCT: GCTACGCCCTG
GCTACGCCCTG: CTACGCCCTGC
CTACGCCCTGC: TACGCCCTGCA
TACGCCCTGCA: ACGCCCTGCAC
ACGCCCTGCAC: CGCCCTGCACC
CGCCCTGCACC: GCCCTGCACCA
GCCCTGCACCA: CCCTGCACCAC
CCCTGCACCAC: CCTGCACCACG
CCTGCACCACG: CTGCACCACGC
CTGCACCACGC: TGCACCACGCT
TGCACCACGCT: GCACCACGCTC
GCACCACGCTC: CACCACGCTCC
CACCACGCTCC: ACCACGCTCCT
ACCACGCTCCT: CCACGCTCCTG
CCACGCTCCTG: CACGCTCCTGC
CACGCTCCTGC: ACGCTCCTGCC
ACGCTCCTGCC: CGCTCCTGCCA
CGCTCCTGCCA: GCTCCTGCCAT
GCTCCTGCCAT: CTCCTGCCATC
CTCCTGCCATC: TCCTGCCATCC
TCCTGCCATCC: CCTGCCATCCA
CCTGCCATCCA: CTGCCATCCAG
CTGCCATCCAG: TGCCATCCAGC
TGCCATCCAGC: GCCATCCAGCA
GCCATCCAGCA: CCATCCAGCAA
CCATCCAGCAA: CATCCAGCAAA
CATCCAGCAAA: ATCCAGCAAAG
ATCCAGCAAAG: TCCAGCAAAGC
TCCAGCAAAGC: CCAGCAAAGCA
CCAGCAAAGCA: CAGCAAAGCAG
CAGCAAAGCAG: AGCAAAGCAGG
AGCAAAGCAGG: GCAAAGCAGGT
GCAAAGCAGGT: CAAAGCAGGTC
CAAAGCAGGTC: AAAGCAGGTCT
AAAGCAGGTCT: AAGCAGGTCTC
AAGCAGGTCTC: AGCAGGTCTCT
AGCAGGTCTCT: GCAGGTCTCTT
GCAGGTCTCTT: CAGGTCTCTTC
CAGGTCTCTTC: AGGTCTCTTCT
AGGTCTCTTCT: GGTCTCTTCTA
GGTCTCTTCTA: GTCTCTTCTAG
GTCTCTTCTAG: TCTCTTCTAGC
TCTCTTCTAGC: CTCTTCTAGCA
CTCTTCTAGCA: TCTTCTAGCAG
TCTTCTAGCAG: CTTCTAGCAGA
CTTCTAGCAGA: TTCTAGCAGAC
TTCTAGCAGAC: TCTAGCAGACC
TCTAGCAGACC: CTAGCAGACCT
CTAGCAGACCT: TAGCAGACCTC
TAGCAGACCTC: AGCAGACCTCC
AGCAGACCTCC: GCAGACCTCCA
GCAGACCTCCA: CAGACCTCCAT
CAGACCTCCAT: AGACCTCCATA
AGACCTCCATA: GACCTCCATAT
GACCTCCATAT: ACCTCCATATG
ACCTCCATATG: CCTCCATATGC
CCTCCATATGC: CTCCATATGCA
CTCCATATGCA: TCCATATGCAG
TCCATATGCAG: CCATATGCAGT
CCATATGCAGT: CATATGCAGTC
CATATGCAGTC: ATATGCAGTCC
ATATGCAGTCC: TATGCAGTCCC
TATGCAGTCCC: ATGCAGTCCCT
ATGCAGTCCCT: TGCAGTCCCTA
TGCAGTCCCTA: GCAGTCCCTAA
GCAGTCCCTAA: CAGTCCCTAAT
CAGTCCCTAAT: AGTCCCTAATC
AGTCCCTAATC: GTCCCTAATCA
GTCCCTAATCA: TCCCTAATCAC
TCCCTAATCAC: CCCTAATCACG
CCCTAATCACG: CCTAATCACGT
CCTAATCACGT: CTAATCACGTC
CTAATCACGTC: TAATCACGTCG
TAATCACGTCG: AATCACGTCGT
AATCACGTCGT: ATCACGTCGTA
ATCACGTCGTA: TCACGTCGTAC
TCACGTCGTAC: CACGTCGTACG
CACGTCGTACG: ACGTCGTACGG
ACGTCGTACGG: CGTCGTACGGA
CGTCGTACGGA: GTCGTACGGAC
GTCGTACGGAC: TCGTACGGACC
TCGTACGGACC: CGTACGGACCA
CGTACGGACCA: GTACGGACCAT
GTACGGACCAT: TACGGACCATT
TACGGACCATT: ACGGACCATTC
ACGGACCATTC: CGGACCATTCT
CGGACCATTCT: GGACCATTCTG
GGACCATTCTG: GACCATTCTGT
GACCATTCTGT: ACCATTCTGTA
ACCATTCTGTA: CCATTCTGTAT
CCATTCTGTAT: CATTCTGTATC
CATTCTGTATC: ATTCTGTATCT
ATTCTGTATCT: TTCTGTATCTT
TTCTGTATCTT: TCTGTATCTTA
TCTGTATCTTA: CTGTATCTTAC
CTGTATCTTAC: TGTATCTTACC
TGTATCTTACC: GTATCTTACCT
GTATCTTACCT: TATCTTACCTT
TATCTTACCTT: ATCTTACCTTA
ATCTTACCTTA: TCTTACCTTAG
TCTTACCTTAG: CTTACCTTAGA
CTTACCTTAGA: TTACCTTAGAA
TTACCTTAGAA: TACCTTAGAAG
TACCTTAGAAG: ACCTTAGAAGA
ACCTTAGAAGA: CCTTAGAAGAA
CCTTAGAAGAA: CTTAGAAGAAT
CTTAGAAGAAT: TTAGAAGAATG
TTAGAAGAATG: TAGAAGAATGC
TAGAAGAATGC: AGAAGAATGCG
AGAAGAATGCG: GAAGAATGCGT
GAAGAATGCGT: AAGAATGCGTG
AAGAATGCGTG: AGAATGCGTGA
AGAATGCGTGA: GAATGCGTGAC
GAATGCGTGAC: AATGCGTGACG
AATGCGTGACG: ATGCGTGACGT
ATGCGTGACGT: TGCGTGACGTT
TGCGTGACGTT: GCGTGACGTTC
GCGTGACGTTC: CGTGACGTTCG
CGTGACGTTCG: GTGACGTTCGC
GTGACGTTCGC: TGACGTTCGCA
TGACGTTCGCA: GACGTTCGCAA
GACGTTCGCAA: ACGTTCGCAAA
ACGTTCGCAAA: CGTTCGCAAAC
CGTTCGCAAAC: GTTCGCAAACC
GTTCGCAAACC: TTCGCAAACCC
TTCGCAAACCC: TCGCAAACCCC
TCGCAAACCCC: CGCAAACCCCG
CGCAAACCCCG: GCAAACCCCGC
GCAAACCCCGC: CAAACCCCGCC
CAAACCCCGCC: AAACCCCGCCG
AAACCCCGCCG: AACCCCGCCGA
AACCCCGCCGA: ACCCCGCCGAG
ACCCCGCCGAG: CCCCGCCGAGG
CCCCGCCGAGG: CCCGCCGAGGT
CCCGCCGAGGT: CCGCCGAGGTT
CCGCCGAGGTT: CGCCGAGGTTA
CGCCGAGGTTA: GCCGAGGTTAC
GCCGAGGTTAC: CCGAGGTTACT
CCGAGGTTACT: CGAGGTTACTA
CGAGGTTACTA: GAGGTTACTAG
GAGGTTACTAG: AGGTTACTAGG
AGGTTACTAGG: GGTTACTAGGG
GGTTACTAGGG: GTTACTAGGGC
GTTACTAGGGC: TTACTAGGGCT
TTACTAGGGCT: TACTAGGGCTG
TACTAGGGCTG: ACTAGGGCTGT
ACTAGGGCTGT: CTAGGGCTGTA
CTAGGGCTGTA: TAGGGCTGTAC
TAGGGCTGTAC: AGGGCTGTACT
AGGGCTGTACT: GGGCTGTACTT
GGGCTGTACTT: GGCTGTACTTC
GGCTGTACTTC: GCTGTACTTCC
GCTGTACTTCC: CTGTACTTCCT
CTGTACTTCCT: TGTACTTCCTG
TGTACTTCCTG: GTACTTCCTGT
GTACTTCCTGT: TACTTCCTGTC
TACTTCCTGTC: ACTTCCTGTCT
ACTTCCTGTCT: CTTCCTGTCTA
CTTCCTGTCTA: TTCCTGTCTAC
TTCCTGTCTAC: TCCTGTCTACG
TCCTGTCTACG: CCTGTCTACGA
CCTGTCTACGA: CTGTCTACGAG
CTGTCTACGAG: TGTCTACGAGC
TGTCTACGAGC: GTCTACGAGCA
GTCTACGAGCA: TCTACGAGCAA
TCTACGAGCAA: CTACGAGCAAG
CTACGAGCAAG: TACGAGCAAGT
TACGAGCAAGT: ACGAGCAAGTG
ACGAGCAAGTG: CGAGCAAGTGA
CGAGCAAGTGA: GAGCAAGTGAA
GAGCAAGTGAA: AGCAAGTGAAT
AGCAAGTGAAT: GCAAGTGAATG
GCAAGTGAATG: CAAGTGAATGA
CAAGTGAATGA: AAGTGAATGAG
AAGTGAATGAG: AGTGAATGAGC
AGTGAATGAGC: GTGAATGAGCA
GTGAATGAGCA: TGAATGAGCAG
TGAATGAGCAG: GAATGAGCAGC GAATGAGCAGA
GAATGAGCAGC: AATGAGCAGCT
AATGAGCAGCT: ATGAGCAGCTA
ATGAGCAGCTA: TGAGCAGCTAA
TGAGCAGCTAA: GAGCAGCTAAC
GAGCAGCTAAC: AGCAGCTAACT
AGCAGCTAACT: GCAGCTAACTA
GCAGCTAACTA: CAGCTAACTAT
CAGCTAACTAT: AGCTAACTATA
AGCTAACTATA: GCTAACTATAG
GCTAACTATAG: CTAACTATAGG
CTAACTATAGG: TAACTATAGGT
TAACTATAGGT: AACTATAGGTT
AACTATAGGTT: ACTATAGGTTA
ACTATAGGTTA: CTATAGGTTAC
CTATAGGTTAC: TATAGGTTACA
TATAGGTTACA: ATAGGTTACAT
ATAGGTTACAT: TAGGTTACATC
TAGGTTACATC: AGGTTACATCC
AGGTTACATCC: GGTTACATCCC
GGTTACATCCC: GTTACATCCCC
GTTACATCCCC: TTACATCCCCA
TTACATCCCCA: TACATCCCCAC
TACATCCCCAC: ACATCCCCACG
ACATCCCCACG: CATCCCCACGA
CATCCCCACGA: ATCCCCACGAT
ATCCCCACGAT: TCCCCACGATA
TCCCCACGATA: CCCCACGATAA
CCCCACGATAA: CCCACGATAAT
CCCACGATAAT: CCACGATAATC
CCACGATAATC: CACGATAATCA
CACGATAATCA: ACGATAATCAG
ACGATAATCAG: CGATAATCAGA
CGATAATCAGA: GATAATCAGAC
GATAATCAGAC: ATAATCAGACA
ATAATCAGACA: TAATCAGACAC
TAATCAGACAC: AATCAGACACA
AATCAGACACA: ATCAGACACAT
ATCAGACACAT: TCAGACACATT
TCAGACACATT: CAGACACATTA
CAGACACATTA: AGACACATTAT
AGACACATTAT: GACACATTATA
GACACATTATA: ACACATTATAA
ACACATTATAA: CACATTATAAT
CACATTATAAT: ACATTATAATA
ACATTATAATA: CATTATAATAT
CATTATAATAT: ATTATAATATC
ATTATAATATC: TTATAATATCA
TTATAATATCA: TATAATATCAA
TATAATATCAA: ATAATATCAAC
ATAATATCAAC: TAATATCAACT
TAATATCAACT: AATATCAACTA
AATATCAACTA: ATATCAACTAG
ATATCAACTAG: TATCAACTAGC
TATCAACTAGC: ATCAACTAGCT
ATCAACTAGCT: TCAACTAGCTA
TCAACTAGCTA: CAACTAGCTAG
CAACTAGCTAG: AACTAGCTAGC
AACTAGCTAGC: ACTAGCTAGCC
ACTAGCTAGCC: CTAGCTAGCCC
CTAGCTAGCCC: TAGCTAGCCCT
TAGCTAGCCCT: AGCTAGCCCTC
AGCTAGCCCTC: GCTAGCCCTCT
GCTAGCCCTCT: CTAGCCCTCTG
CTAGCCCTCTG: TAGCCCTCTGT
TAGCCCTCTGT: AGCCCTCTGTG
AGCCCTCTGTG: GCCCTCTGTGA
GCCCTCTGTGA: CCCTCTGTGAT
CCCTCTGTGAT: CCTCTGTGATG
CCTCTGTGATG: CTCTGTGATGA
CTCTGTGATGA: TCTGTGATGAA
TCTGTGATGAA: CTGTGATGAAT
CTGTGATGAAT: TGTGATGAATG
TGTGATGAATG: GTGATGAATGA
GTGATGAATGA: TGATGAATGAG
TGATGAATGAG: GATGAATGAGC
GATGAATGAGC: ATGAATGAGCA
ATGAATGAGCA: TGAATGAGCAG
GAATGAGCAGA: AATGAGCAGAG
AATGAGCAGAG: ATGAGCAGAGA
ATGAGCAGAGA: TGAGCAGAGAG
TGAGCAGAGAG: GAGCAGAGAGT
GAGCAGAGAGT: AGCAGAGAGTA
AGCAGAGAGTA: GCAGAGAGTAC
GCAGAGAGTAC: CAGAGAGTACA
CAGAGAGTACA: AGAGAGTACAG
AGAGAGTACAG: GAGAGTACAGA
GAGAGTACAGA: AGAGTACAGAA
AGAGTACAGAA: GAGTACAGAAT
GAGTACAGAAT: AGTACAGAATT
AGTACAGAATT: GTACAGAATTA
GTACAGAATTA: TACAGAATTAC
TACAGAATTAC: ACAGAATTACG
ACAGAATTACG: CAGAATTACGT
CAGAATTACGT: AGAATTACGTA
AGAATTACGTA: GAATTACGTAG
GAATTACGTAG: AATTACGTAGC
AATTACGTAGC: ATTACGTAGCC
ATTACGTAGCC: TTACGTAGCCC
TTACGTAGCCC: TACGTAGCCCA
TACGTAGCCCA: ACGTAGCCCAA
ACGTAGCCCAA: CGTAGCCCAAA
CGTAGCCCAAA: GTAGCCCAAAC
GTAGCCCAAAC: TAGCCCAAACC
TAGCCCAAACC: AGCCCAAACCC
AGCCCAAACCC: GCCCAAACCCG
GCCCAAACCCG: CCCAAACCCGA
CCCAAACCCGA: CCAAACCCGAG
CCAAACCCGAG: CAAACCCGAGG
CAAACCCGAGG: AAACCCGAGGG
AAACCCGAGGG: AACCCGAGGGG
AACCCGAGGGG: ACCCGAGGGGT
ACCCGAGGGGT: CCCGAGGGGTA
CCCGAGGGGTA: CCGAGGGGTAT
CCGAGGGGTAT: CGAGGGGTATT
CGAGGGGTATT: GAGGGGTATTG
GAGGGGTATTG: AGGGGTATTGC
AGGGGTATTGC: GGGGTATTGCC
GGGGTATTGCC: GGGTATTGCCA
GGGTATTGCCA: GGTATTGCCAG
GGTATTGCCAG: GTATTGCCAGG
GTATTGCCAGG: TATTGCCAGGG
TATTGCCAGGG: ATTGCCAGGGG
ATTGCCAGGGG: TTGCCAGGGGC
TTGCCAGGGGC: TGCCAGGGGCG
TGCCAGGGGCG: GCCAGGGGCGC
GCCAGGGGCGC: CCAGGGGCGCT
CCAGGGGCGCT: CAGGGGCGCTC
CAGGGGCGCTC: AGGGGCGCTCA
AGGGGCGCTCA: GGGGCGCTCAG
GGGGCGCTCAG: GGGCGCTCAGG
GGGCGCTCAGG: GGCGCTCAGGT
GGCGCTCAGGT: GCGCTCAGGTC
GCGCTCAGGTC: CGCTCAGGTCA
CGCTCAGGTCA: GCTCAGGTCAG
GCTCAGGTCAG: CTCAGGTCAGC
CTCAGGTCAGC: TCAGGTCAGCG
TCAGGTCAGCG: CAGGTCAGCGT
CAGGTCAGCGT: AGGTCAGCGTG
AGGTCAGCGTG: GGTCAGCGTGC
GGTCAGCGTGC: GTCAGCGTGCG
GTCAGCGTGCG: TCAGCGTGCGT
TCAGCGTGCGT: CAGCGTGCGTG
CAGCGTGCGTG: AGCGTGCGTGA
AGCGTGCGTGA: GCGTGCGTGAG
GCGTGCGTGAG: CGTGCGTGAGG
CGTGCGTGAGG: GTGCGTGAGGG
GTGCGTGAGGG: TGCGTGAGGGA
TGCGTGAGGGA: GCGTGAGGGAA
GCGTGAGGGAA: CGTGAGGGAAA
CGTGAGGGAAA: GTGAGGGAAAC
GTGAGGGAAAC: TGAGGGAAACT
TGAGGGAAACT: GAGGGAAACTC
GAGGGAAACTC: AGGGAAACTCA
AGGGAAACTCA: GGGAAACTCAA
GGGAAACTCAA: GGAAACTCAAC
GGAAACTCAAC: GAAACTCAACT
GAAACTCAACT: AAACTCAACTG
AAACTCAACTG: AACTCAACTGA
AACTCAACTGA: ACTCAACTGAG
ACTCAACTGAG: CTCAACTGAGG
CTCAACTGAGG: TCAACTGAGGG
TCAACTGAGGG: CAACTGAGGGC
CAACTGAGGGC: AACTGAGGGCA
AACTGAGGGCA: ACTGAGGGCAA
ACTGAGGGCAA: CTGAGGGCAAA
CTGAGGGCAAA: TGAGGGCAAAT
TGAGGGCAAAT: GAGGGCAAATA
GAGGGCAAATA: AGGGCAAATAT
AGGGCAAATAT: GGGCAAATATA
GGGCAAATATA: GGCAAATATAA
GGCAAATATAA: GCAAATATAAT
GCAAATATAAT: CAAATATAATG
CAAATATAATG: AAATATAATGA
AAATATAATGA: AATATAATGAG
AATATAATGAG: ATATAATGAGA
ATATAATGAGA: TATAATGAGAC
TATAATGAGAC: ATAATGAGACG
ATAATGAGACG: TAATGAGACGA
TAATGAGACGA: AATGAGACGAC
AATGAGACGAC: ATGAGACGACC
ATGAGACGACC: TGAGACGACCC
TGAGACGACCC: GAGACGACCCC
GAGACGACCCC: AGACGACCCCT
AGACGACCCCT: GACGACCCCTT
GACGACCCCTT: ACGACCCCTTA
ACGACCCCTTA: CGACCCCTTAC
CGACCCCTTAC: GACCCCTTACT
GACCCCTTACT: ACCCCTTACTT
ACCCCTTACTT: CCCCTTACTTC
CCCCTTACTTC: CCCTTACTTCA
CCCTTACTTCA: CCTTACTTCAC
CCTTACTTCAC: CTTACTTCACT
CTTACTTCACT: TTACTTCACTT
TTACTTCACTT: TACTTCACTTA
TACTTCACTTA: ACTTCACTTAA
ACTTCACTTAA: CTTCACTTAAA
CTTCACTTAAA: TTCACTTAAAC
TTCACTTAAAC: TCACTTAAACG
TCACTTAAACG: CACTTAAACGA
CACTTAAACGA: ACTTAAACGAA
ACTTAAACGAA: CTTAAACGAAA
CTTAAACGAAA: TTAAACGAAAC
TTAAACGAAAC: TAAACGAAACC
TAAACGAAACC: AAACGAAACCG
AAACGAAACCG: AACGAAACCGA
AACGAAACCGA: ACGAAACCGAA
ACGAAACCGAA: CGAAACCGAAT
CGAAACCGAAT: GAAACCGAATG
GAAACCGAATG: AAACCGAATGC
AAACCGAATGC: AACCGAATGCT
AACCGAATGCT: ACCGAATGCTC
ACCGAATGCTC: CCGAATGCTCC
CCGAATGCTCC: CGAATGCTCCA
CGAATGCTCCA: GAATGCTCCAA
GAATGCTCCAA: AATGCTCCAAT
AATGCTCCAAT: ATGCTCCAATT
ATGCTCCAATT: TGCTCCAATTC
TGCTCCAATTC: GCTCCAATTCG
GCTCCAATTCG: CTCCAATTCGA
CTCCAATTCGA: TCCAATTCGAT
TCCAATTCGAT: CCAATTCGATT
CCAATTCGATT: CAATTCGATTC
CAATTCGATTC: AATTCGATTCG
AATTCGATTCG: ATTCGATTCGT
ATTCGATTCGT: TTCGATTCGTT
TTCGATTCGTT: TCGATTCGTTC
TCGATTCGTTC: CGATTCGTTCC
CGATTCGTTCC: GATTCGTTCCA
GATTCGTTCCA: ATTCGTTCCAC
ATTCGTTCCAC: TTCGTTCCACG
TTCGTTCCACG: TCGTTCCACGG
TCGTTCCACGG: CGTTCCACGGT
CGTTCCACGGT: GTTCCACGGTC
GTTCCACGGTC: TTCCACGGTCC
TTCCACGGTCC: TCCACGGTCCA
TCCACGGTCCA: CCACGGTCCAT
CCACGGTCCAT: CACGGTCCATC
CACGGTCCATC: ACGGTCCATCA
ACGGTCCATCA: CGGTCCATCAC
CGGTCCATCAC: GGTCCATCACT
GGTCCATCACT: GTCCATCACTT
GTCCATCACTT: TCCATCACTTT
TCCATCACTTT: CCATCACTTTC
CCATCACTTTC: CATCACTTTCA
CATCACTTTCA: ATCACTTTCAT
ATCACTTTCAT: TCACTTTCATA
TCACTTTCATA: CACTTTCATAA
CACTTTCATAA: ACTTTCATAAA
ACTTTCATAAA: CTTTCATAAAT
CTTTCATAAAT: TTTCATAAATC
TTTCATAAATC: TTCATAAATCT
TTCATAAATCT: TCATAAATCTA
TCATAAATCTA: CATAAATCTAA
CATAAATCTAA: ATAAATCTAAT
ATAAATCTAAT: TAAATCTAATT
TAAATCTAATT: AAATCTAATTG
AAATCTAATTG: AATCTAATTGC
AATCTAATTGC: ATCTAATTGCT
ATCTAATTGCT: TCTAATTGCTG
TCTAATTGCTG: CTAATTGCTGT
CTAATTGCTGT: TAATTGCTGTG
TAATTGCTGTG: AATTGCTGTGC
AATTGCTGTGC: ATTGCTGTGCC
ATTGCTGTGCC: TTGCTGTGCCT
TTGCTGTGCCT: TGCTGTGCCTC
TGCTGTGCCTC: GCTGTGCCTCA
GCTGTGCCTCA: CTGTGCCTCAC
CTGTGCCTCAC: TGTGCCTCACA
TGTGCCTCACA: GTGCCTCACAA
GTGCCTCACAA: TGCCTCACAAT
TGCCTCACAAT: GCCTCACAATC
GCCTCACAATC: CCTCACAATCG
CCTCACAATCG: CTCACAATCGA
CTCACAATCGA: TCACAATCGAG
TCACAATCGAG: CACAATCGAGC
CACAATCGAGC: ACAATCGAGCC
ACAATCGAGCC: CAATCGAGCCA
CAATCGAGCCA: AATCGAGCCAG
AATCGAGCCAG: ATCGAGCCAGC
ATCGAGCCAGC: TCGAGCCAGCA
TCGAGCCAGCA: CGAGCCAGCAA
CGAGCCAGCAA: GAGCCAGCAAT
GAGCCAGCAAT: AGCCAGCAATG
AGCCAGCAATG: GCCAGCAATGT
GCCAGCAATGT: CCAGCAATGTT
CCAGCAATGTT: CAGCAATGTTA
CAGCAATGTTA: AGCAATGTTAC
AGCAATGTTAC: GCAATGTTACC
GCAATGTTACC: CAATGTTACCA
CAATGTTACCA: AATGTTACCAT
AATGTTACCAT: ATGTTACCATT
ATGTTACCATT: TGTTACCATTT
TGTTACCATTT: GTTACCATTTG
GTTACCATTTG: TTACCATTTGC
TTACCATTTGC: TACCATTTGCA
TACCATTTGCA: ACCATTTGCAT
ACCATTTGCAT: CCATTTGCATA
CCATTTGCATA: CATTTGCATAC
CATTTGCATAC: ATTTGCATACC
ATTTGCATACC: TTTGCATACCC
TTTGCATACCC: TTGCATACCCT
TTGCATACCCT: TGCATACCCTG
TGCATACCCTG: GCATACCCTGT
GCATACCCTGT: CATACCCTGTT
CATACCCTGTT: ATACCCTGTTG
ATACCCTGTTG: TACCCTGTTGA
TACCCTGTTGA: ACCCTGTTGAG
ACCCTGTTGAG: CCCTGTTGAGA
CCCTGTTGAGA: CCTGTTGAGAT
CCTGTTGAGAT: CTGTTGAGATA
CTGTTGAGATA: TGTTGAGATAT
TGTTGAGATAT: GTTGAGATATT
GTTGAGATATT: TTGAGATATTA
TTGAGATATTA: TGAGATATTAT
TGAGATATTAT: GAGATATTATG
GAGATATTATG: AGATATTATGC
AGATATTATGC: GATATTATGCG
GATATTATGCG: ATATTATGCGT
ATATTATGCGT: TATTATGCGTG
TATTATGCGTG: ATTATGCGTGC
ATTATGCGTGC: TTATGCGTGCC
TTATGCGTGCC: TATGCGTGCCG
TATGCGTGCCG: ATGCGTGCCGT
ATGCGTGCCGT: TGCGTGCCGTG
TGCGTGCCGTG: GCGTGCCGTGA
GCGTGCCGTGA: CGTGCCGTGAC
CGTGCCGTGAC: GTGCCGTGACA
GTGCCGTGACA: TGCCGTGACAT
TGCCGTGACAT: GCCGTGACATA
GCCGTGACATA: CCGTGACATAG
CCGTGACATAG: CGTGACATAGC
CGTGACATAGC: GTGACATAGCT
GTGACATAGCT: TGACATAGCTA
TGACATAGCTA: GACATAGCTAG
GACATAGCTAG: ACATAGCTAGC
ACATAGCTAGC: CATAGCTAGCT
CATAGCTAGCT: ATAGCTAGCTT
ATAGCTAGCTT: TAGCTAGCTTT
TAGCTAGCTTT: AGCTAGCTTTA
AGCTAGCTTTA: GCTAGCTTTAT
GCTAGCTTTAT: CTAGCTTTATG
CTAGCTTTATG: TAGCTTTATGA
TAGCTTTATGA: AGCTTTATGAA
AGCTTTATGAA: GCTTTATGAAG
GCTTTATGAAG: CTTTATGAAGC
CTTTATGAAGC: TTTATGAAGCG
TTTATGAAGCG: TTATGAAGCGC
TTATGAAGCGC: TATGAAGCGCC
TATGAAGCGCC: ATGAAGCGCCT
ATGAAGCGCCT: TGAAGCGCCTC
TGAAGCGCCTC: GAAGCGCCTCC
GAAGCGCCTCC: AAGCGCCTCCA
AAGCGCCTCCA: AGCGCCTCCAG
AGCGCCTCCAG: GCGCCTCCAGT
GCGCCTCCAGT: CGCCTCCAGTT
CGCCTCCAGTT: GCCTCCAGTTA
GCCTCCAGTTA: CCTCCAGTTAT
CCTCCAGTTAT: CTCCAGTTATC
CTCCAGTTATC: TCCAGTTATCC
TCCAGTTATCC: CCAGTTATCCA
CCAGTTATCCA: CAGTTATCCAA
CAGTTATCCAA: AGTTATCCAAC
AGTTATCCAAC: GTTATCCAACT
GTTATCCAACT: TTATCCAACTT
TTATCCAACTT: TATCCAACTTC
TATCCAACTTC: ATCCAACTTCG
ATCCAACTTCG: TCCAACTTCGG
TCCAACTTCGG: CCAACTTCGGG
CCAACTTCGGG: CAACTTCGGGG
CAACTTCGGGG: AACTTCGGGGC
AACTTCGGGGC: ACTTCGGGGCG
ACTTCGGGGCG: CTTCGGGGCGA
CTTCGGGGCGA: TTCGGGGCGAG
TTCGGGGCGAG: TCGGGGCGAGT
TCGGGGCGAGT: CGGGGCGAGTG
CGGGGCGAGTG: GGGGCGAGTGG
GGGGCGAGTGG: GGGCGAGTGGG
GGGCGAGTGGG: GGCGAGTGGGT
GGCGAGTGGGT: GCGAGTGGGTG
GCGAGTGGGTG: CGAGTGGGTGT
CGAGTGGGTGT: GAGTGGGTGTG
GAGTGGGTGTG: AGTGGGTGTGT
AGTGGGTGTGT: GTGGGTGTGTA
GTGGGTGTGTA: TGGGTGTGTAA
TGGGTGTGTAA: GGGTGTGTAAA
GGGTGTGTAAA: GGTGTGTAAAA
GGTGTGTAAAA: GTGTGTAAAAG
GTGTGTAAAAG: TGTGTAAAAGT
TGTGTAAAAGT: GTGTAAAAGTA
GTGTAAAAGTA: TGTAAAAGTAT
TGTAAAAGTAT: GTAAAAGTATC
GTAAAAGTATC: TAAAAGTATCA
TAAAAGTATCA: AAAAGTATCAT
AAAAGTATCAT: AAAGTATCATC
AAAGTATCATC: AAGTATCATCG
AAGTATCATCG: AGTATCATCGC
AGTATCATCGC: GTATCATCGCG
GTATCATCGCG: TATCATCGCGA
TATCATCGCGA: ATCATCGCGAT
ATCATCGCGAT: TCATCGCGATC
TCATCGCGATC: CATCGCGATCC
CATCGCGATCC: ATCGCGATCCC
ATCGCGATCCC: TCGCGATCCCG
TCGCGATCCCG: CGCGATCCCGA
CGCGATCCCGA: GCGATCCCGAT
GCGATCCCGAT: CGATCCCGATC
CGATCCCGATC: GATCCCGATCC
GATCCCGATCC: ATCCCGATCCT
ATCCCGATCCT: TCCCGATCCTC
TCCCGATCCTC: CCCGATCCTCG
CCCGATCCTCG: CCGATCCTCGA
CCGATCCTCGA: CGATCCTCGAC
CGATCCTCGAC: GATCCTCGACG
GATCCTCGACG: ATCCTCGACGT
ATCCTCGACGT: TCCTCGACGTC
TCCTCGACGTC: CCTCGACGTCT
CCTCGACGTCT: CTCGACGTCTC
CTCGACGTCTC: TCGACGTCTCC
TCGACGTCTCC: CGACGTCTCCG
CGACGTCTCCG: GACGTCTCCGA
GACGTCTCCGA: ACGTCTCCGAA
ACGTCTCCGAA: CGTCTCCGAAT
CGTCTCCGAAT: GTCTCCGAATA
GTCTCCGAATA: TCTCCGAATAC
TCTCCGAATAC: CTCCGAATACC
CTCCGAATACC: TCCGAATACCT
TCCGAATACCT: CCGAATACCTC
CCGAATACCTC: CGAATACCTCT
CGAATACCTCT: GAATACCTCTA
GAATACCTCTA: AATACCTCTAA
AATACCTCTAA: ATACCTCTAAG
ATACCTCTAAG: TACCTCTAAGG
TACCTCTAAGG: ACCTCTAAGGA
ACCTCTAAGGA: CCTCTAAGGAA
CCTCTAAGGAA: CTCTAAGGAAT
CTCTAAGGAAT: TCTAAGGAATA
TCTAAGGAATA: CTAAGGAATAT
CTAAGGAATAT: TAAGGAATATG
TAAGGAATATG: AAGGAATATGC
AAGGAATATGC: AGGAATATGCT
AGGAATATGCT: GGAATATGCTT
GGAATATGCTT: GAATATGCTTT
GAATATGCTTT: AATATGCTTTA
AATATGCTTTA: ATATGCTTTAG
ATATGCTTTAG: TATGCTTTAGT
TATGCTTTAGT: ATGCTTTAGTA
ATGCTTTAGTA: TGCTTTAGTAC
TGCTTTAGTAC: GCTTTAGTACC
GCTTTAGTACC: CTTTAGTACCC
CTTTAGTACCC: TTTAGTACCCC
TTTAGTACCCC: TTAGTACCCCC
TTAGTACCCCC: TAGTACCCCCT
TAGTACCCCCT: AGTACCCCCTG
AGTACCCCCTG: GTACCCCCTGC
GTACCCCCTGC: TACCCCCTGCG
TACCCCCTGCG: ACCCCCTGCGA
ACCCCCTGCGA: CCCCCTGCGAA
CCCCCTGCGAA: CCCCTGCGAAG
CCCCTGCGAAG: CCCTGCGAAGC
CCCTGCGAAGC: CCTGCGAAGCA
CCTGCGAAGCA: CTGCGAAGCAC
CTGCGAAGCAC: TGCGAAGCACT
TGCGAAGCACT: GCGAAGCACTA
GCGAAGCACTA: CGAAGCACTAG
CGAAGCACTAG: GAAGCACTAGG
GAAGCACTAGG: AAGCACTAGGA
AAGCACTAGGA: AGCACTAGGAA
AGCACTAGGAA: GCACTAGGAAT
GCACTAGGAAT: CACTAGGAATG
CACTAGGAATG: ACTAGGAATGG
ACTAGGAATGG: CTAGGAATGGG
CTAGGAATGGG: TAGGAATGGGT
TAGGAATGGGT: AGGAATGGGTG
AGGAATGGGTG: GGAATGGGTGT
GGAATGGGTGT: GAATGGGTGTC
GAATGGGTGTC: AATGGGTGTCT
AATGGGTGTCT: ATGGGTGTCTT
ATGGGTGTCTT: TGGGTGTCTTG
TGGGTGTCTTG: GGGTGTCTTGT
GGGTGTCTTGT: GGTGTCTTGTC
GGTGTCTTGTC: GTGTCTTGTCT
GTGTCTTGTCT: TGTCTTGTCTC
TGTCTTGTCTC: GTCTTGTCTCC
GTCTTGTCTCC: TCTTGTCTCCT
TCTTGTCTCCT: CTTGTCTCCTC
CTTGTCTCCTC: TTGTCTCCTCT
TTGTCTCCTCT: TGTCTCCTCTA
TGTCTCCTCTA: GTCTCCTCTAA
GTCTCCTCTAA: TCTCCTCTAAT
TCTCCTCTAAT: CTCCTCTAATG
CTCCTCTAATG: TCCTCTAATGA
TCCTCTAATGA: CCTCTAATGAA
CCTCTAATGAA: CTCTAATGAAT
CTCTAATGAAT: TCTAATGAATT
TCTAATGAATT: CTAATGAATTG
CTAATGAATTG: TAATGAATTGG
TAATGAATTGG: AATGAATTGGT
AATGAATTGGT: ATGAATTGGTT
ATGAATTGGTT: TGAATTGGTTA
TGAATTGGTTA: GAATTGGTTAG
GAATTGGTTAG: AATTGGTTAGT
AATTGGTTAGT: ATTGGTTAGTG
ATTGGTTAGTG: TTGGTTAGTGT
TTGGTTAGTGT: TGGTTAGTGTT
TGGTTAGTGTT: GGTTAGTGTTA
GGTTAGTGTTA: GTTAGTGTTAA
GTTAGTGTTAA: TTAGTGTTAAC
TTAGTGTTAAC: TAGTGTTAACA
TAGTGTTAACA: AGTGTTAACAC
AGTGTTAACAC: GTGTTAACACC
GTGTTAACACC: TGTTAACACCC
TGTTAACACCC: GTTAACACCCG
GTTAACACCCG: TTAACACCCGT
TTAACACCCGT: TAACACCCGTA
TAACACCCGTA: AACACCCGTAT
AACACCCGTAT: ACACCCGTATG
ACACCCGTATG: CACCCGTATGG
CACCCGTATGG: ACCCGTATGGA
ACCCGTATGGA: CCCGTATGGAA
CCCGTATGGAA: CCGTATGGAAC
CCGTATGGAAC: CGTATGGAACT
CGTATGGAACT: GTATGGAACTT
GTATGGAACTT: TATGGAACTTG
TATGGAACTTG: ATGGAACTTGC
ATGGAACTTGC: TGGAACTTGCC