AGGGACTCAACAGTCGGGC: GGGACTCAACAGTCGGGCA
ACTACGAGCGCAGTACTTT: CTACGAGCGCAGTACTTTA
ATACAGGCAGTACTTTATG: TACAGGCAGTACTTTATGG
CTCCCATACAACGCCTCGT: TCCCATACAACGCCTCGTA
GCGCCATGCTGCCAGAACT: CGCCATGCTGCCAGAACTA
AGCAGGAGACGTGCGCACT: GCAGGAGACGTGCGCACTT
CACGCTTGTATCTTTGGCT: ACGCTTGTATCTTTGGCTT
GCGAGTCACAATCTGTTGC: CGAGTCACAATCTGTTGCA
AATACTGTAGGGATGTCTG: ATACTGTAGGGATGTCTGG
GGAGCTCATGCAGTACTTT: GAGCTCATGCAGTACTTTA
GGTGCCACCTAGTACCTTG: GTGCCACCTAGTACCTTGC
CTGTGACTCTGCTTGAGCT: TGTGACTCTGCTTGAGCTG
AGTTGTATAACCGATCATA: GTTGTATAACCGATCATAA
GCAATCGCAGGGACTCAAC: CAATCGCAGGGACTCAACA
ATAAGGCGAGCAGGAGACG: TAAGGCGAGCAGGAGACGT
CAGAGGATCAAGTGGACTT: AGAGGATCAAGTGGACTTT
ATTAAAGCGACGTGACGAC: TTAAAGCGACGTGACGACG
ACAGGGAGCGAGTCACAAT: CAGGGAGCGAGTCACAATC
CTAATTGTCGGGACTACTA: TAATTGTCGGGACTACTAT
TGGCACCAAGATACAAATT: GGCACCAAGATACAAATTC
ACTGGGAGGCTTTTAACCC: CTGGGAGGCTTTTAACCCA
ATTGGTTCACGCTTGTATC: TTGGTTCACGCTTGTATCT
TACAACGCCTCGTAGGTAC: ACAACGCCTCGTAGGTACT
GTCCATGTACTTTTCTGAG: TCCATGTACTTTTCTGAGC
ACTATTGGTCCATGTACTT: CTATTGGTCCATGTACTTT
CCGCAAAGCGGGTGCCAGT: CGCAAAGCGGGTGCCAGTC
CCAAGTGGAGTTGAGTGAC: CAAGTGGAGTTGAGTGACG
GGTATCGTGCCGGCATATC: GTATCGTGCCGGCATATCC
ATATCTTGCAGCTTCTTCA: TATCTTGCAGCTTCTTCAC
TTTTAACCCACTGATTCGG: TTTAACCCACTGATTCGGG
GGGGTATCGTGCCGGCATA: GGGTATCGTGCCGGCATAT
TAAAGGTGTATTCAACTAT: AAAGGTGTATTCAACTATA
TCGTGATGCTATAAAAGCA: CGTGATGCTATAAAAGCAG
ACAAAGCATCTTACTTTAC: CAAAGCATCTTACTTTACC
TTCTCAGGCAAGGGCTGCC: TCTCAGGCAAGGGCTGCCG
TTTCTCGTAAGAGCCCGGG: TTCTCGTAAGAGCCCGGGA
AATGTCACTTAAAATGTTC: ATGTCACTTAAAATGTTCA
CGGTGCGAGCAACATGTGT: GGTGCGAGCAACATGTGTC
ACACCCCCTATTGCACAGG: CACCCCCTATTGCACAGGG
TCGGGAAATTGGAGGCGGC: CGGGAAATTGGAGGCGGCG
GGAAAAGACTACGAGCGCA: GAAAAGACTACGAGCGCAG
GTCAAGGAATATGGCATCC: TCAAGGAATATGGCATCCT
GCTGCTGAGGGGTATCGTG: CTGCTGAGGGGTATCGTGC
CCGATCATAAGCTCGTAAG: CGATCATAAGCTCGTAAGT
CGGTTAAAGGTGTATTCAA: GGTTAAAGGTGTATTCAAC
AAGGTGTATTCAACTATAA: AGGTGTATTCAACTATAAT
CTTGAACCTACTTGGCGTT: TTGAACCTACTTGGCGTTG
AATTGTCGGGACTACTATA: ATTGTCGGGACTACTATAT
CTTCACGCTTGTATCTTTG: TTCACGCTTGTATCTTTGG TTCACGCTTGTATCTTTGG
TCGAACTCGTTGCACGGCA: CGAACTCGTTGCACGGCAG
CGACACCAATTGGTCCGTG: GACACCAATTGGTCCGTGC
GTCTGGTCCAAAGTATCTT: TCTGGTCCAAAGTATCTTG
CTCGTAGGTACTCATCTTG: TCGTAGGTACTCATCTTGA
GATCTCGGCCGCTCGTAAA: ATCTCGGCCGCTCGTAAAC
TCTCCATTTCCTTGGGGTG: CTCCATTTCCTTGGGGTGC
TGCGCAGTACGTTGTAGGC: GCGCAGTACGTTGTAGGCG
ACCTAGTACCTTGCATTGC: CCTAGTACCTTGCATTGCC
GGACCCCAATCGTAGTGGC: GACCCCAATCGTAGTGGCC
CCCTAGGCTGCGTTGGAGC: CCTAGGCTGCGTTGGAGCT
TCTAATTGTCGGGACTACT: CTAATTGTCGGGACTACTA
TGTCAGCTTAGTCCTTCTT: GTCAGCTTAGTCCTTCTTC
GTTCTTCGAGGTATGGATC: TTCTTCGAGGTATGGATCT
GTACTTAGGCAATCGCAGG: TACTTAGGCAATCGCAGGG
GGCTTGATCTCACAAAGCA: GCTTGATCTCACAAAGCAT
TGCACGTATAACATGCCTC: GCACGTATAACATGCCTCG
GATTATGGTGAGTGGCAGT: ATTATGGTGAGTGGCAGTT
CTTCGAGGTATGGATCTCG: TTCGAGGTATGGATCTCGG
GCGTTTAGTGACGGGGGTA: CGTTTAGTGACGGGGGTAT
TGCCTCGCGTGAATACACT: GCCTCGCGTGAATACACTC
CAGGAAGTAAACTCGATAG: AGGAAGTAAACTCGATAGG
TCACAAAGCATCTTACTTT: CACAAAGCATCTTACTTTA
TGAGAGGCTACCATTCAAC: GAGAGGCTACCATTCAACA
TCTTCGAGGTATGGATCTC: CTTCGAGGTATGGATCTCG
TATTTCTCACGCGGTCGCG: ATTTCTCACGCGGTCGCGG
CAGACGGTGCGAGCAACAT: AGACGGTGCGAGCAACATG
CCGTTACGGACCCCAATCG: CGTTACGGACCCCAATCGT
AAAAGGCGGTGTCAGCTTA: AAAGGCGGTGTCAGCTTAG
GCTTTTAACCCACTGATTC: CTTTTAACCCACTGATTCG
CAGGCAAGGGCTGCCGTGA: AGGCAAGGGCTGCCGTGAA
GCCGGCGGTTGCGGGAGCG: CCGGCGGTTGCGGGAGCGA
TTGTATCTTTGGGCACGGT: TGTATCTTTGGGCACGGTA
CCCCCGAAGGGGCACTGCT: CCCCGAAGGGGCACTGCTG
TAGGTACTCATCTTGATAA: AGGTACTCATCTTGATAAG
TGTTGCACGTATAACATGC: GTTGCACGTATAACATGCC
GCGTAATGCGGTCCGATCA: CGTAATGCGGTCCGATCAC
CTTAACGCGTAGCAGGTCA: TTAACGCGTAGCAGGTCAG
GCGACGAACACACAAGAGC: CGACGAACACACAAGAGCC
CTTACTTTACCATCTGCAT: TTACTTTACCATCTGCATA
AACATGTGTCTAATTGTCG: ACATGTGTCTAATTGTCGG
GGTGCCATATTTCTCACGC: GTGCCATATTTCTCACGCG
CGTCGCCAACGAAATACAC: GTCGCCAACGAAATACACG
ATCTTGGGTTGGAGACACA: TCTTGGGTTGGAGACACAG
ACTGATTCGGGTTTTCTTT: CTGATTCGGGTTTTCTTTG
CATAGTCAAGGAATATGGC: ATAGTCAAGGAATATGGCA
GCAGCTTCTTCACGCTTGT: CAGCTTCTTCACGCTTGTA
TATTGGCGTCGCCCACGGA: ATTGGCGTCGCCCACGGAG
ACTACTATATTATACGTAC: CTACTATATTATACGTACT
CTTGCAGCTTCTTCACGCT: TTGCAGCTTCTTCACGCTT
AGCGGGTGCCAGTCGCGGT: GCGGGTGCCAGTCGCGGTA
ACATGATCTGGCGCCATGC: CATGATCTGGCGCCATGCT
CGAGGTATGGATCTCGGCC: GAGGTATGGATCTCGGCCG
GGCATATCCAAGTCTTAGA: GCATATCCAAGTCTTAGAC
GCACGTATAACATGCCTCG: CACGTATAACATGCCTCGG
CAGTATCCGGCGCCGACAC: AGTATCCGGCGCCGACACC
GGTCGTGATGCTATAAAAG: GTCGTGATGCTATAAAAGC
GTCGCCCACGGAGCTATCC: TCGCCCACGGAGCTATCCT
AGTCAAGGAATATGGCATC: GTCAAGGAATATGGCATCC
TATGGATATGATTAGCCAG: ATGGATATGATTAGCCAGC
TTCTCCCGATCGAAGGTAC: TCTCCCGATCGAAGGTACT
GTGTATTCAACTATAATAA: TGTATTCAACTATAATAAT
ACTTAAAATGTTCAGGAGC: CTTAAAATGTTCAGGAGCT
AAGTTGTATAACCGATCAT: AGTTGTATAACCGATCATA
GTTGTATAACCGATCATAA: TTGTATAACCGATCATAAG
TACTTGGCGTTGCCAAGTG: ACTTGGCGTTGCCAAGTGG
TTGTAGGCGAGGCTAGCGG: TGTAGGCGAGGCTAGCGGT
TCGCGTCGCCAACGAAATA: CGCGTCGCCAACGAAATAC
TATGGTGAGTGGCAGTTCT: ATGGTGAGTGGCAGTTCTG
GTATCGTGCCGGCATATCC: TATCGTGCCGGCATATCCA
ATTGTCGGGACTACTATAT: TTGTCGGGACTACTATATT
CCATTCTCAGGCAAGGGCT: CATTCTCAGGCAAGGGCTG
TTCAGGAGCTCATGCAGTA: TCAGGAGCTCATGCAGTAC
TAGGTAAACCCAGCTATTG: AGGTAAACCCAGCTATTGA
GTTTAGTCGCGTCGCCAAC: TTTAGTCGCGTCGCCAACG
GTAAACCAGTGGCAGAACC: TAAACCAGTGGCAGAACCG
CTGGGAGGCTTTTAACCCA: TGGGAGGCTTTTAACCCAC
CTTACGAGTCGAGAAATAC: TTACGAGTCGAGAAATACC
GCGTAGCAGGTCAGACGGT: CGTAGCAGGTCAGACGGTG
ACCCCAATCGTAGTGGCCC: CCCCAATCGTAGTGGCCCT
CACACAGCTAGTGAGAGGC: ACACAGCTAGTGAGAGGCT
CAAGTGGACTTTTAAGACC: AAGTGGACTTTTAAGACCG
TACCTGCGCAGTACGTTGT: ACCTGCGCAGTACGTTGTA
GTCGTGATGCTATAAAAGC: TCGTGATGCTATAAAAGCA
AACCAAGGGAACATACAGG: ACCAAGGGAACATACAGGC
TGCGCGGGAAAAGACTACG: GCGCGGGAAAAGACTACGA
ATAGGCCAGTCTATTCACG: TAGGCCAGTCTATTCACGC
CAACGCCTCGTAGGTACTC: AACGCCTCGTAGGTACTCA
CAGCCCTTTTTCTCGTAAG: AGCCCTTTTTCTCGTAAGA
GTCGCGTCGCCAACGAAAT: TCGCGTCGCCAACGAAATA
CCCTTTTTCTCGTAAGAGC: CCTTTTTCTCGTAAGAGCC
GTTAAAGGTGTATTCAACT: TTAAAGGTGTATTCAACTA
TCTTTGGCCCCCCCTAGGC: CTTTGGCCCCCCCTAGGCT
AGACCGCAAAGCGGGTGCC: GACCGCAAAGCGGGTGCCA
GGTACTCATCTTGATAAGG: GTACTCATCTTGATAAGGC
TGGGCACGGTAAGTTGTAT: GGGCACGGTAAGTTGTATA
TACCATCTGCATAAGACGC: ACCATCTGCATAAGACGCA
GCCAGTCTATTCACGCTTG: CCAGTCTATTCACGCTTGT
GGGTATCGTGCCGGCATAT: GGTATCGTGCCGGCATATC
GCCGGCATATCCAAGTCTT: CCGGCATATCCAAGTCTTA
GCAGAACCGGTAATACTGT: CAGAACCGGTAATACTGTA
GACTAAATTGCGTTTAGTG: ACTAAATTGCGTTTAGTGA
CTTCTTCCGCTTCAAGAGT: TTCTTCCGCTTCAAGAGTT
AGTACTTTATGGATATGAT: GTACTTTATGGATATGATT
ACTCGCAATGCCTCGGGGT: CTCGCAATGCCTCGGGGTT
GATAGGTAAACCCAGCTAT: ATAGGTAAACCCAGCTATT
GGCGGTGTCAGCTTAGTCC: GCGGTGTCAGCTTAGTCCT
CTCGAGCTGAAGAACTTTA: TCGAGCTGAAGAACTTTAG
GCGCCGACACCAATTGGTC: CGCCGACACCAATTGGTCC
GCTTACGAGTCGAGAAATA: CTTACGAGTCGAGAAATAC
TGAACCTACTTGGCGTTGC: GAACCTACTTGGCGTTGCC
CGATTGTACTTAGGCAATC: GATTGTACTTAGGCAATCG
TCGAGGTACACCCCCTATT: CGAGGTACACCCCCTATTG
TAGTGACGGGGGTATACAT: AGTGACGGGGGTATACATG
CGACGTGACGACGGTGCCA: GACGTGACGACGGTGCCAT
TAAAGCGACGTGACGACGG: AAAGCGACGTGACGACGGT
TCTGCTTGAGCTGCCCGTT: CTGCTTGAGCTGCCCGTTA
TCCGTCTGAAACCATTCTC: CCGTCTGAAACCATTCTCA
CTATTGAATACCAGTATTC: TATTGAATACCAGTATTCT
GGCAGAGATTAAAGCGACG: GCAGAGATTAAAGCGACGT
ATCCAAGTCTTAGACGTTT: TCCAAGTCTTAGACGTTTG
GACTACGAGCGCAGTACTT: ACTACGAGCGCAGTACTTT
TCTGGTCCAAAGTATCTTG: CTGGTCCAAAGTATCTTGG
TTAGTGACGGGGGTATACA: TAGTGACGGGGGTATACAT
CCGGTGCTGCTGAGGGGTA: CGGTGCTGCTGAGGGGTAT
CGGTAACATCAGCCCTTTT: GGTAACATCAGCCCTTTTT
AAGTGGACTTTTAAGACCG: AGTGGACTTTTAAGACCGC
GAGGGGTATCGTGCCGGCA: AGGGGTATCGTGCCGGCAT
TTCTGAGCGAGCGCGTAAT: TCTGAGCGAGCGCGTAATG
ATCATTCTTAGATATTTGG: TCATTCTTAGATATTTGGA
GGATATAGGCCAGTCTATT: GATATAGGCCAGTCTATTC
GAATTCATCGAGAACGCGA: AATTCATCGAGAACGCGAC
GAGTTGAGTGACGCCTCCC: AGTTGAGTGACGCCTCCCA
GCGCAGTACTTTATGGATA: CGCAGTACTTTATGGATAT
AGCTGCCCGTTACGGACCC: GCTGCCCGTTACGGACCCC
CCTCTGCCATAGTCAAGGA: CTCTGCCATAGTCAAGGAA
CCCGGTGCTGCTGAGGGGT: CCGGTGCTGCTGAGGGGTA
CCTTGGGGTGCCACCTAGT: CTTGGGGTGCCACCTAGTA
GGTAACACAGATCGATGTC: GTAACACAGATCGATGTCC
CTCGAATGTCACTTAAAAT: TCGAATGTCACTTAAAATG
ATCGTAGTGGCCCTCCCCC: TCGTAGTGGCCCTCCCCCG
CTTTGGGTACTCATGAACT: TTTGGGTACTCATGAACTC
GGAGGCTTTTAACCCACTG: GAGGCTTTTAACCCACTGA
GTATAACATGCCTCGGGAA: TATAACATGCCTCGGGAAA
TGCTGCTGAGGGGTATCGT: GCTGCTGAGGGGTATCGTG
CCGGGACAGCTGCCGCCTT: CGGGACAGCTGCCGCCTTC
TAGTGGACGCAAGCTTACG: AGTGGACGCAAGCTTACGA
CCTGTCTGATAGAGAGGAG: CTGTCTGATAGAGAGGAGT
TCCGTGCGCGGGAAAAGAC: CCGTGCGCGGGAAAAGACT
GAGTGACGCCTCCCATACA: AGTGACGCCTCCCATACAA
AGGTAAACCCAGCTATTGA: GGTAAACCCAGCTATTGAA
GCGGGAAAAGACTACGAGC: CGGGAAAAGACTACGAGCG
CCGCACACAGCTAGTGAGA: CGCACACAGCTAGTGAGAG
CTCATGAACTCGAACTCGT: TCATGAACTCGAACTCGTT
GAGCTCATGCAGTACTTTA: AGCTCATGCAGTACTTTAT
CATACAACGCCTCGTAGGT: ATACAACGCCTCGTAGGTA
GGCATAGTCCGGGCTTTAA: GCATAGTCCGGGCTTTAAA
TTAGTCGCGTCGCCAACGA: TAGTCGCGTCGCCAACGAA
TGTCCGCACACAGCTAGTG: GTCCGCACACAGCTAGTGA
CTTAGGCAATCGCAGGGAC: TTAGGCAATCGCAGGGACT
CCTGATATACAAGGCAAAA: CTGATATACAAGGCAAAAA
TTATGGATATGATTAGCCA: TATGGATATGATTAGCCAG
AGCTTCACGCTTGTATCTT: GCTTCACGCTTGTATCTTT
AACTTTAGGGAAGCGCAGA: ACTTTAGGGAAGCGCAGAG
TCGAGAAATACCTGCGCAG: CGAGAAATACCTGCGCAGT
AAACCAGTGGCAGAACCGG: AACCAGTGGCAGAACCGGT
GCCGTGAATACGCCCGCGT: CCGTGAATACGCCCGCGTT
ATGCGGTCCGATCACAAAC: TGCGGTCCGATCACAAACT
AATTCATCGAGAACGCGAC: ATTCATCGAGAACGCGACT
GTATGTGCCTGGCCGGCGG: TATGTGCCTGGCCGGCGGT
AGAGATTAAAGCGACGTGA: GAGATTAAAGCGACGTGAC
TTGGCCCCCCCTAGGCTGC: TGGCCCCCCCTAGGCTGCG
CACGCTTGTATCTTTGGCG: ACGCTTGTATCTTTGGCGC
TGAGCTGCCCGTTACGGAC: GAGCTGCCCGTTACGGACC
GGTCCGTGCGCGGGAAAAG: GTCCGTGCGCGGGAAAAGA
TGGACTTTTAAGACCGCAA: GGACTTTTAAGACCGCAAA
TTGCGTTTAGTGACGGGGG: TGCGTTTAGTGACGGGGGT
GGAGTTGAGTGACGCCTCC: GAGTTGAGTGACGCCTCCC
GAGTGGCAGTTCTGACACA: AGTGGCAGTTCTGACACAG
TATTTGGAACTATTAACTG: ATTTGGAACTATTAACTGG
CGCAGAGGATCAAGTGGAC: GCAGAGGATCAAGTGGACT
CGATCATAAGCTCGTAAGT: GATCATAAGCTCGTAAGTA
GGTTCTTCGAGGTATGGAT: GTTCTTCGAGGTATGGATC
CGCCTTCGGTTAAAGGTGT: GCCTTCGGTTAAAGGTGTA
GATTGGTTCACGCTTGTAT: ATTGGTTCACGCTTGTATC
ATTACGGGATTGGTTCACG: TTACGGGATTGGTTCACGC
TTGTACTTAGGCAATCGCA: TGTACTTAGGCAATCGCAG
CGCTTGTATCTTTGGCTTG: GCTTGTATCTTTGGCTTGA
GATATGATTAGCCAGCTTC: ATATGATTAGCCAGCTTCA
GTACTCGCAATGCCTCGGG: TACTCGCAATGCCTCGGGG
TGCGAGCAACATGTGTCTA: GCGAGCAACATGTGTCTAA
AATGCCTGCAACCAAGGGA: ATGCCTGCAACCAAGGGAA
AGCGACGTGACGACGGTGC: GCGACGTGACGACGGTGCC
GCTTGTATCTTTGGCCCCC: CTTGTATCTTTGGCCCCCC
TAGCCAGCTTCACGCTTGT: AGCCAGCTTCACGCTTGTA
AAGAGTTGTAGTTGCACCG: AGAGTTGTAGTTGCACCGC
CGCGTGAATACACTCTTCT: GCGTGAATACACTCTTCTT
ACACTCTTCTTTACCCTCG: CACTCTTCTTTACCCTCGT
GATCCTGGTAACACAGATC: ATCCTGGTAACACAGATCG
TATGAACTGGGAGGCTTTT: ATGAACTGGGAGGCTTTTA
GGTTGCGGGAGCGACGAAC: GTTGCGGGAGCGACGAACA
AACTCGTTGCACGGCAGAG: ACTCGTTGCACGGCAGAGA
TACCTTGCATTGCCTCGCG: ACCTTGCATTGCCTCGCGT
CACCCCCTATTGCACAGGG: ACCCCCTATTGCACAGGGA
ACAGGAAGTAAACTCGATA: CAGGAAGTAAACTCGATAG
TACCAGTATTCTCCATTTC: ACCAGTATTCTCCATTTCC
TGCATTGCCTCGCGTGAAT: GCATTGCCTCGCGTGAATA
ATTGCCTCGTCAACGGCAA: TTGCCTCGTCAACGGCAAC
GGTATGGATCTCGGCCGCT: GTATGGATCTCGGCCGCTC
CTATAAAAGCAGCCCGGTG: TATAAAAGCAGCCCGGTGC
CTTTGGCACCAAGATACAA: TTTGGCACCAAGATACAAA
ACGTGACGACGGTGCCATA: CGTGACGACGGTGCCATAT
CGCACACAGCTAGTGAGAG: GCACACAGCTAGTGAGAGG
TAACCGATCATAAGCTCGT: AACCGATCATAAGCTCGTA
GCGCATCTGCATCTTGAAC: CGCATCTGCATCTTGAACC
TATAACCGATCATAAGCTC: ATAACCGATCATAAGCTCG
CCACCTAGTACCTTGCATT: CACCTAGTACCTTGCATTG
CACGGTAAGTTGTATAACC: ACGGTAAGTTGTATAACCG
TAACATCAGCCCTTTTTCT: AACATCAGCCCTTTTTCTC
TTGGAGGCGGCGGGACCCT: TGGAGGCGGCGGGACCCTC
TGCGGTCCGATCACAAACT: GCGGTCCGATCACAAACTA
TCGTGCCGGCATATCCAAG: CGTGCCGGCATATCCAAGT
GGCGTCGCCCACGGAGCTA: GCGTCGCCCACGGAGCTAT
TCAATTGGGCTGGGGATCC: CAATTGGGCTGGGGATCCT
TTATGGATATCTTGCAGCT: TATGGATATCTTGCAGCTT
GCCTGGCCGGCGGTTGCGG: CCTGGCCGGCGGTTGCGGG
AGCAGGTCAGACGGTGCGA: GCAGGTCAGACGGTGCGAG
TGCAACCAAGGGAACATAC: GCAACCAAGGGAACATACA
CTACTTGGCGTTGCCAAGT: TACTTGGCGTTGCCAAGTG
GGTCCGATCACAAACTAAC: GTCCGATCACAAACTAACG
GGCCCTCCCCCGAAGGGGC: GCCCTCCCCCGAAGGGGCA
CAAGGCAAAAAGGCGGTGT: AAGGCAAAAAGGCGGTGTC
AGTCTATTCACGCTTGTAT: GTCTATTCACGCTTGTATC
GCCTGCAACCAAGGGAACA: CCTGCAACCAAGGGAACAT
GCTTGTATCTTTGGCTTGA: CTTGTATCTTTGGCTTGAT
ACTCATGAACTCGAACTCG: CTCATGAACTCGAACTCGT
GGTAACATCAGCCCTTTTT: GTAACATCAGCCCTTTTTC
CTGATTATGGTGAGTGGCA: TGATTATGGTGAGTGGCAG
TGGCCCCCCCTAGGCTGCG: GGCCCCCCCTAGGCTGCGT
CGGACCCCAATCGTAGTGG: GGACCCCAATCGTAGTGGC
TCGAGGTATGGATCTCGGC: CGAGGTATGGATCTCGGCC
TTAACCCACTGATTCGGGT: TAACCCACTGATTCGGGTT
GAGCAACATGTGTCTAATT: AGCAACATGTGTCTAATTG
CATTCAACATGTATTGGCG: ATTCAACATGTATTGGCGT
CGAGCGCGTAATGCGGTCC: GAGCGCGTAATGCGGTCCG
ATTCTCAGGCAAGGGCTGC: TTCTCAGGCAAGGGCTGCC
CATGAACTCGAACTCGTTG: ATGAACTCGAACTCGTTGC
TTGCACCGCCTCGCGATTG: TGCACCGCCTCGCGATTGT
ATCAAGTGGACTTTTAAGA: TCAAGTGGACTTTTAAGAC
ACCTTGCATTGCCTCGCGT: CCTTGCATTGCCTCGCGTG
CACAGGAAGTAAACTCGAT: ACAGGAAGTAAACTCGATA
GTGACGCCTCCCATACAAC: TGACGCCTCCCATACAACG
CAGCTGCCGCCTTCGGTTA: AGCTGCCGCCTTCGGTTAA
CCATAGTCAAGGAATATGG: CATAGTCAAGGAATATGGC
CGCGGTCGCGGTTATATTG: GCGGTCGCGGTTATATTGT
TACAGGCAGTACTTTATGG: ACAGGCAGTACTTTATGGA
TGGAGTTGAGTGACGCCTC: GGAGTTGAGTGACGCCTCC
TGTTCAGGAGCTCATGCAG: GTTCAGGAGCTCATGCAGT
CGAAATACACGACGCTGTT: GAAATACACGACGCTGTTC
TTCACGCTTGTATCTTTGG: TCACGCTTGTATCTTTGGC TCACGCTTGTATCTTTGGC TCACGCTTGTATCTTTGGG TCACGCTTGTATCTTTGGC
ATATTACGGGATTGGTTCA: TATTACGGGATTGGTTCAC
AAACAGGTGCCTACTGCTG: AACAGGTGCCTACTGCTGT
ACGCAGCTTTCTCCCGATC: CGCAGCTTTCTCCCGATCG
TGGCAGAACCGGTAATACT: GGCAGAACCGGTAATACTG
CCAAGATACAAATTCTTAA: CAAGATACAAATTCTTAAC
CTGCCGTGAATACGCCCGC: TGCCGTGAATACGCCCGCG
TCCGGCGCCGACACCAATT: CCGGCGCCGACACCAATTG
TTTTCTGAGCGAGCGCGTA: TTTCTGAGCGAGCGCGTAA
GTCCAAAGTATCTTGGGTT: TCCAAAGTATCTTGGGTTG
CGAGCGCAGTACTTTATGG: GAGCGCAGTACTTTATGGA
TATTACGGGATTGGTTCAC: ATTACGGGATTGGTTCACG
AGTAACCCCGTATGTGCCT: GTAACCCCGTATGTGCCTG
AGTGGACGCAAGCTTACGA: GTGGACGCAAGCTTACGAG
CAGGCAGTACTTTATGGAT: AGGCAGTACTTTATGGATA
TACGGGATTGGTTCACGCT: ACGGGATTGGTTCACGCTT
CACTGATTCGGGTTTTCTT: ACTGATTCGGGTTTTCTTT
ACATACAGGCAGTACTTTA: CATACAGGCAGTACTTTAT
CCCGCGTTCGCAGTATCCG: CCGCGTTCGCAGTATCCGG
GTAGTTGCACCGCCTCGCG: TAGTTGCACCGCCTCGCGA
GTAAGTAACCCCGTATGTG: TAAGTAACCCCGTATGTGC
TAATAATCCGTCTGAAACC: AATAATCCGTCTGAAACCA
CGATGTCCGCACACAGCTA: GATGTCCGCACACAGCTAG
TGTCACTTAAAATGTTCAG: GTCACTTAAAATGTTCAGG
CGGGAAAAGACTACGAGCG: GGGAAAAGACTACGAGCGC
TCTATAGTGGACGCAAGCT: CTATAGTGGACGCAAGCTT
GTACACCCCCTATTGCACA: TACACCCCCTATTGCACAG
AACCCCGTATGTGCCTGGC: ACCCCGTATGTGCCTGGCC
CTGATTCGGGTTTTCTTTG: TGATTCGGGTTTTCTTTGG
CGTTTGTAAGCCTGTCTGA: GTTTGTAAGCCTGTCTGAT
ATGGCATCCTCAATGCCTG: TGGCATCCTCAATGCCTGC
TACTCATGAACTCGAACTC: ACTCATGAACTCGAACTCG
CAATCGTAGTGGCCCTCCC: AATCGTAGTGGCCCTCCCC
GGTCCAAAGTATCTTGGGT: GTCCAAAGTATCTTGGGTT
GATTCGGGTTTTCTTTGGG: ATTCGGGTTTTCTTTGGGT
AGCTCGAATGTCACTTAAA: GCTCGAATGTCACTTAAAA
AAAGCATCTTACTTTACCA: AAGCATCTTACTTTACCAT
GTTACGGACCCCAATCGTA: TTACGGACCCCAATCGTAG
CGAACTCGTTGCACGGCAG: GAACTCGTTGCACGGCAGA
ATATCCAAGTCTTAGACGT: TATCCAAGTCTTAGACGTT
TCACAATCTGTTGCACGTA: CACAATCTGTTGCACGTAT
ATCTTTGGCGCATCTGCAT: TCTTTGGCGCATCTGCATC
TGTATTCAACTATAATAAT: GTATTCAACTATAATAATC
GCATATCCAAGTCTTAGAC: CATATCCAAGTCTTAGACG
TTGGTTCACGCTTGTATCT: TGGTTCACGCTTGTATCTT
GACTCTGCTTGAGCTGCCC: ACTCTGCTTGAGCTGCCCG
AATACCAGTATTCTCCATT: ATACCAGTATTCTCCATTT
AATGTTCAGGAGCTCATGC: ATGTTCAGGAGCTCATGCA
AATCCGTCTGAAACCATTC: ATCCGTCTGAAACCATTCT
GCTACCATTCAACATGTAT: CTACCATTCAACATGTATT
GTCCGATCACAAACTAACG: TCCGATCACAAACTAACGT
GCGTTCGCAGTATCCGGCG: CGTTCGCAGTATCCGGCGC
TGCATAAGACGCAGCTTTC: GCATAAGACGCAGCTTTCT
GTCCCATTGCCTCGTCAAC: TCCCATTGCCTCGTCAACG
GCGGTTATATTGTGGCCAC: CGGTTATATTGTGGCCACC
CCGCTTCAAGAGTTGTAGT: CGCTTCAAGAGTTGTAGTT
TACTGCTGTCGAGGTACAC: ACTGCTGTCGAGGTACACC
AGATTAAAGCGACGTGACG: GATTAAAGCGACGTGACGA
AGCGCGTAATGCGGTCCGA: GCGCGTAATGCGGTCCGAT
ATGAACTGGGAGGCTTTTA: TGAACTGGGAGGCTTTTAA
GCGTGAATACACTCTTCTT: CGTGAATACACTCTTCTTT
CGCCCGCGTTCGCAGTATC: GCCCGCGTTCGCAGTATCC
GAGTCACAATCTGTTGCAC: AGTCACAATCTGTTGCACG
TGCCTCGGGGTTCTTCGAG: GCCTCGGGGTTCTTCGAGG
ATGGTGAGTGGCAGTTCTG: TGGTGAGTGGCAGTTCTGA
AGGCGGTGTCAGCTTAGTC: GGCGGTGTCAGCTTAGTCC
GCCAGTCGCGGTAACATCA: CCAGTCGCGGTAACATCAG
ATACAAATTCTTAACGCGT: TACAAATTCTTAACGCGTA
TCGGTTAAAGGTGTATTCA: CGGTTAAAGGTGTATTCAA
TGGAGCTCGAATGTCACTT: GGAGCTCGAATGTCACTTA
TAGAGGTATGAACTGGGAG: AGAGGTATGAACTGGGAGG
AACAGTCGGGCATAGTCCG: ACAGTCGGGCATAGTCCGG
ACAAATTCTTAACGCGTAG: CAAATTCTTAACGCGTAGC
GCAGAGGATCAAGTGGACT: CAGAGGATCAAGTGGACTT
AACGCGTAGCAGGTCAGAC: ACGCGTAGCAGGTCAGACG
CTTTATGGATATCTTGCAG: TTTATGGATATCTTGCAGC
TTCTCGTAAGAGCCCGGGA: TCTCGTAAGAGCCCGGGAC
AGGGATGTCTGGTCCAAAG: GGGATGTCTGGTCCAAAGT
GTTCAGGAGCTCATGCAGT: TTCAGGAGCTCATGCAGTA
ATGATCTGGCGCCATGCTG: TGATCTGGCGCCATGCTGC
ACGGGATTGGTTCACGCTT: CGGGATTGGTTCACGCTTG
GATCGAAGGTACTCGCAAT: ATCGAAGGTACTCGCAATG
AGGAATATGGCATCCTCAA: GGAATATGGCATCCTCAAT
TTGCATTGCCTCGCGTGAA: TGCATTGCCTCGCGTGAAT
GCGGTCGCGGTTATATTGT: CGGTCGCGGTTATATTGTG
TACGAGTCGAGAAATACCT: ACGAGTCGAGAAATACCTG
GCCCGCGTTCGCAGTATCC: CCCGCGTTCGCAGTATCCG
CCTGGCCGGCGGTTGCGGG: CTGGCCGGCGGTTGCGGGA
ACTCGAACTCGTTGCACGG: CTCGAACTCGTTGCACGGC
GGAAGCGCAGAGGATCAAG: GAAGCGCAGAGGATCAAGT
GCCATATTTCTCACGCGGT: CCATATTTCTCACGCGGTC
TGTATAACCGATCATAAGC: GTATAACCGATCATAAGCT
TTAACGCGTAGCAGGTCAG: TAACGCGTAGCAGGTCAGA
ACATCAGCCCTTTTTCTCG: CATCAGCCCTTTTTCTCGT
TCGTAAGAGCCCGGGACAG: CGTAAGAGCCCGGGACAGC
TTGAGATCATTCTTAGATA: TGAGATCATTCTTAGATAT
GGATCAAGTGGACTTTTAA: GATCAAGTGGACTTTTAAG
TGCCTACTGCTGTCGAGGT: GCCTACTGCTGTCGAGGTA
TCGTAAACCAGTGGCAGAA: CGTAAACCAGTGGCAGAAC
GAGGTATGGATCTCGGCCG: AGGTATGGATCTCGGCCGC
TTAGGCAATCGCAGGGACT: TAGGCAATCGCAGGGACTC
AATCTGTTGCACGTATAAC: ATCTGTTGCACGTATAACA
ACTAACGTTTAGTCGCGTC: CTAACGTTTAGTCGCGTCG
GAAAGGTTTTGAGATCATT: AAAGGTTTTGAGATCATTC
TGGTTCCTTTATAGATTTG: GGTTCCTTTATAGATTTGT
CGCCAACGAAATACACGAC: GCCAACGAAATACACGACG
ATCTATAGTGGACGCAAGC: TCTATAGTGGACGCAAGCT
CCCAGCGTAAACTTTGGCA: CCAGCGTAAACTTTGGCAC
TTTTCTTTGGGTACTCATG: TTTCTTTGGGTACTCATGA
TGGCGTCGCCCACGGAGCT: GGCGTCGCCCACGGAGCTA
GAGCGAGTCACAATCTGTT: AGCGAGTCACAATCTGTTG
ACGCGGTCGCGGTTATATT: CGCGGTCGCGGTTATATTG
AAAAAAAAACAGGTGCCTA: AAAAAAAACAGGTGCCTAC
GTAGAATTCATCGAGAACG: TAGAATTCATCGAGAACGC
CCAAGGGAACATACAGGCA: CAAGGGAACATACAGGCAG
TACTGTAGGGATGTCTGGT: ACTGTAGGGATGTCTGGTC
TTAACTGGTTCCTTTATAG: TAACTGGTTCCTTTATAGA
TGCTGCCAGAACTATTGGT: GCTGCCAGAACTATTGGTC
ACTTTAGGGAAGCGCAGAG: CTTTAGGGAAGCGCAGAGG
TGTACTTAGGCAATCGCAG: GTACTTAGGCAATCGCAGG
AAAGCGGGTGCCAGTCGCG: AAGCGGGTGCCAGTCGCGG
ATATTTCTCACGCGGTCGC: TATTTCTCACGCGGTCGCG
CCCCTAGGCTGCGTTGGAG: CCCTAGGCTGCGTTGGAGC
AGCTATTGAATACCAGTAT: GCTATTGAATACCAGTATT
GATCTGGCGCCATGCTGCC: ATCTGGCGCCATGCTGCCA
GTAAGTTGTATAACCGATC: TAAGTTGTATAACCGATCA
GGCGGTTGCGGGAGCGACG: GCGGTTGCGGGAGCGACGA
GTATCCGGCGCCGACACCA: TATCCGGCGCCGACACCAA
CGCATCTGCATCTTGAACC: GCATCTGCATCTTGAACCT
AAAGGCGGTGTCAGCTTAG: AAGGCGGTGTCAGCTTAGT
ACTCGATAGGTAAACCCAG: CTCGATAGGTAAACCCAGC
GGGCTGCCGTGAATACGCC: GGCTGCCGTGAATACGCCC
ATACATGATCTGGCGCCAT: TACATGATCTGGCGCCATG
CGATCGAAGGTACTCGCAA: GATCGAAGGTACTCGCAAT
ATTAGCCAGCTTCACGCTT: TTAGCCAGCTTCACGCTTG
AATGCCTCGGGGTTCTTCG: ATGCCTCGGGGTTCTTCGA
AGCGCAGAGGATCAAGTGG: GCGCAGAGGATCAAGTGGA
TTTGGAACTATTAACTGGT: TTGGAACTATTAACTGGTT
GCCAAGTGGAGTTGAGTGA: CCAAGTGGAGTTGAGTGAC
CCAGTGGCAGAACCGGTAA: CAGTGGCAGAACCGGTAAT
GACGCCTCCCATACAACGC: ACGCCTCCCATACAACGCC
GATTAAAGCGACGTGACGA: ATTAAAGCGACGTGACGAC
TAAGCCTGTCTGATAGAGA: AAGCCTGTCTGATAGAGAG
CGTTTAGTCGCGTCGCCAA: GTTTAGTCGCGTCGCCAAC
TTGATAAGGCGAGCAGGAG: TGATAAGGCGAGCAGGAGA
GGAAATTGGAGGCGGCGGG: GAAATTGGAGGCGGCGGGA
CGGTCCGATCACAAACTAA: GGTCCGATCACAAACTAAC
AGCGAGCGCGTAATGCGGT: GCGAGCGCGTAATGCGGTC
TCTGAAACCATTCTCAGGC: CTGAAACCATTCTCAGGCA
CGTAAGAGCCCGGGACAGC: GTAAGAGCCCGGGACAGCT
CGAGTCACAATCTGTTGCA: GAGTCACAATCTGTTGCAC
TTTAGTGACGGGGGTATAC: TTAGTGACGGGGGTATACA
CCAGAACTATTGGTCCATG: CAGAACTATTGGTCCATGT
GGGTTTTCTTTGGGTACTC: GGTTTTCTTTGGGTACTCA
AAGAGCCAATCTATAGTGG: AGAGCCAATCTATAGTGGA
GCCTCGTAGGTACTCATCT: CCTCGTAGGTACTCATCTT
AGCAGCAGTACTTTATGGA: GCAGCAGTACTTTATGGAT
GCCCGGTGCTGCTGAGGGG: CCCGGTGCTGCTGAGGGGT
GCTGGGGATCCTGGTAACA: CTGGGGATCCTGGTAACAC
ACAGATCGATGTCCGCACA: CAGATCGATGTCCGCACAC
ACCCCGTATGTGCCTGGCC: CCCCGTATGTGCCTGGCCG
GAGGCTACCATTCAACATG: AGGCTACCATTCAACATGT
CATGTGTCTAATTGTCGGG: ATGTGTCTAATTGTCGGGA
AGACGGTGCGAGCAACATG: GACGGTGCGAGCAACATGT
ACCTGCGCAGTACGTTGTA: CCTGCGCAGTACGTTGTAG
CGAGCAACATGTGTCTAAT: GAGCAACATGTGTCTAATT
GCAGCTTTCTCCCGATCGA: CAGCTTTCTCCCGATCGAA
CACCGCCTCGCGATTGTAC: ACCGCCTCGCGATTGTACT
ACTAAATTGCGTTTAGTGA: CTAAATTGCGTTTAGTGAC
ACAGGTGCCTACTGCTGTC: CAGGTGCCTACTGCTGTCG
TGTCGAGGTACACCCCCTA: GTCGAGGTACACCCCCTAT
AAAGCAGCCCGGTGCTGCT: AAGCAGCCCGGTGCTGCTG
ATGGATATCTTGCAGCTTC: TGGATATCTTGCAGCTTCT
TTCTTCACGCTTGTATCTT: TCTTCACGCTTGTATCTTT
ATAGTCAAGGAATATGGCA: TAGTCAAGGAATATGGCAT
GTATCTTTGGCTTGATCTC: TATCTTTGGCTTGATCTCA
TTGCACAGGGAGCGAGTCA: TGCACAGGGAGCGAGTCAC
GTAAACTTTGGCACCAAGA: TAAACTTTGGCACCAAGAT
GTTTTCTTTGGGTACTCAT: TTTTCTTTGGGTACTCATG
CAGCTTTCTCCCGATCGAA: AGCTTTCTCCCGATCGAAG
GCCATGCTGCCAGAACTAT: CCATGCTGCCAGAACTATT
TTCGGTTAAAGGTGTATTC: TCGGTTAAAGGTGTATTCA
ACGCCTCCCATACAACGCC: CGCCTCCCATACAACGCCT
CCCGATCGAAGGTACTCGC: CCGATCGAAGGTACTCGCA
AACGTTTAGTCGCGTCGCC: ACGTTTAGTCGCGTCGCCA
TTTTTCTCGTAAGAGCCCG: TTTTCTCGTAAGAGCCCGG
CTGCATCTTGAACCTACTT: TGCATCTTGAACCTACTTG
CTTCGGTTAAAGGTGTATT: TTCGGTTAAAGGTGTATTC
GCCTTCGGTTAAAGGTGTA: CCTTCGGTTAAAGGTGTAT
AGTGGAGTTGAGTGACGCC: GTGGAGTTGAGTGACGCCT
GGTACTCATGAACTCGAAC: GTACTCATGAACTCGAACT
ATGCTGCCAGAACTATTGG: TGCTGCCAGAACTATTGGT
CGAGGCTAGCGGTCGTGAT: GAGGCTAGCGGTCGTGATG
TCGTCAACGGCAACCCAGC: CGTCAACGGCAACCCAGCG
CGTCGCCCACGGAGCTATC: GTCGCCCACGGAGCTATCC
AATTCTTAACGCGTAGCAG: ATTCTTAACGCGTAGCAGG
GCTTCACGCTTGTATCTTT: CTTCACGCTTGTATCTTTG
CGCTTGTATCTTTGGCGCA: GCTTGTATCTTTGGCGCAT
TAGGGATGTCTGGTCCAAA: AGGGATGTCTGGTCCAAAG
CTTTATAGATTTGTAGAAT: TTTATAGATTTGTAGAATT
CGCAGTACTTTATGGATAT: GCAGTACTTTATGGATATC
CTTGGGTTGGAGACACAGC: TTGGGTTGGAGACACAGCA
CTTGTATCTTTGGGCACGG: TTGTATCTTTGGGCACGGT
CACAGCAGCAGTACTTTAT: ACAGCAGCAGTACTTTATG
GTGGACCTGGAGTCCCATT: TGGACCTGGAGTCCCATTG
CCGTGAATACGCCCGCGTT: CGTGAATACGCCCGCGTTC
GTATGAACTGGGAGGCTTT: TATGAACTGGGAGGCTTTT
GATCGATGTCCGCACACAG: ATCGATGTCCGCACACAGC
GGGATGTCTGGTCCAAAGT: GGATGTCTGGTCCAAAGTA
GTTGCACCGCCTCGCGATT: TTGCACCGCCTCGCGATTG
GCAAAGCGGGTGCCAGTCG: CAAAGCGGGTGCCAGTCGC
TGGACGCAAGCTTACGAGT: GGACGCAAGCTTACGAGTC
TATCTTTGGCTTGATCTCA: ATCTTTGGCTTGATCTCAC
TAGGCCAGTCTATTCACGC: AGGCCAGTCTATTCACGCT
ATGCCTGCAACCAAGGGAA: TGCCTGCAACCAAGGGAAC
TAGACGTTTGTAAGCCTGT: AGACGTTTGTAAGCCTGTC
GTATTCTCCATTTCCTTGG: TATTCTCCATTTCCTTGGG
AGAGCCAATCTATAGTGGA: GAGCCAATCTATAGTGGAC
GCGGCGGGACCCTCGAGCT: CGGCGGGACCCTCGAGCTG
TTATGGTGAGTGGCAGTTC: TATGGTGAGTGGCAGTTCT
TGCACCGCCTCGCGATTGT: GCACCGCCTCGCGATTGTA
GGGCTGGGGATCCTGGTAA: GGCTGGGGATCCTGGTAAC
ATGCAGTACTTTATGGATA: TGCAGTACTTTATGGATAT
CTCTGCTTGAGCTGCCCGT: TCTGCTTGAGCTGCCCGTT
TCCTTTATAGATTTGTAGA: CCTTTATAGATTTGTAGAA
TTGGGCACGGTAAGTTGTA: TGGGCACGGTAAGTTGTAT
ATGCTATAAAAGCAGCCCG: TGCTATAAAAGCAGCCCGG
ACCCAGCTATTGAATACCA: CCCAGCTATTGAATACCAG
TTCTTAGATATTTGGAACT: TCTTAGATATTTGGAACTA
ATACACGACGCTGTTCAAT: TACACGACGCTGTTCAATT
CATTCTCAGGCAAGGGCTG: ATTCTCAGGCAAGGGCTGC
AATGCGGTCCGATCACAAA: ATGCGGTCCGATCACAAAC
GCAGTACTTTATGGATATA: CAGTACTTTATGGATATAG
AACGCGACTAAATTGCGTT: ACGCGACTAAATTGCGTTT
AGTACTTTATGGATATAGG: GTACTTTATGGATATAGGC
GAAGCGCAGAGGATCAAGT: AAGCGCAGAGGATCAAGTG
CCCGGGACAGCTGCCGCCT: CCGGGACAGCTGCCGCCTT
GGCACGGTAAGTTGTATAA: GCACGGTAAGTTGTATAAC
GAACTTTAGGGAAGCGCAG: AACTTTAGGGAAGCGCAGA
CCTAGTACCTTGCATTGCC: CTAGTACCTTGCATTGCCT
TCGTGGACCTGGAGTCCCA: CGTGGACCTGGAGTCCCAT
TGTGGCCACCGAGGCTGCC: GTGGCCACCGAGGCTGCCC
AGGAGACGTGCGCACTTAG: GGAGACGTGCGCACTTAGG
GAACTCGTTGCACGGCAGA: AACTCGTTGCACGGCAGAG
TGGCGCCATGCTGCCAGAA: GGCGCCATGCTGCCAGAAC
CGCCATGCTGCCAGAACTA: GCCATGCTGCCAGAACTAT
CACGGAGCTATCCTGATAT: ACGGAGCTATCCTGATATA
GTACCTTGCATTGCCTCGC: TACCTTGCATTGCCTCGCG
GGTTTTGAGATCATTCTTA: GTTTTGAGATCATTCTTAG
ATGTTCAGGAGCTCATGCA: TGTTCAGGAGCTCATGCAG
CTGGGGATCCTGGTAACAC: TGGGGATCCTGGTAACACA
CCCATTGCCTCGTCAACGG: CCATTGCCTCGTCAACGGC
TGCGGGAGCGACGAACACA: GCGGGAGCGACGAACACAC
GATGTCTGGTCCAAAGTAT: ATGTCTGGTCCAAAGTATC
TAGGCTGCGTTGGAGCTCG: AGGCTGCGTTGGAGCTCGA
CGTGAATACACTCTTCTTT: GTGAATACACTCTTCTTTA
GGGTGCCACCTAGTACCTT: GGTGCCACCTAGTACCTTG
TTATACGTACTGTGACTCT: TATACGTACTGTGACTCTG
TCAAGTGGACTTTTAAGAC: CAAGTGGACTTTTAAGACC
GATGCTATAAAAGCAGCCC: ATGCTATAAAAGCAGCCCG
GCCTCGGGAAATTGGAGGC: CCTCGGGAAATTGGAGGCG
GTGAGAGGCTACCATTCAA: TGAGAGGCTACCATTCAAC
ACGAACACACAAGAGCCAA: CGAACACACAAGAGCCAAT
ATACTGTAGGGATGTCTGG: TACTGTAGGGATGTCTGGT
GGAGCTATCCTGATATACA: GAGCTATCCTGATATACAA
TTGTATAACCGATCATAAG: TGTATAACCGATCATAAGC
TGTAGGGATGTCTGGTCCA: GTAGGGATGTCTGGTCCAA
GTCGCCAACGAAATACACG: TCGCCAACGAAATACACGA
CTCGATAGGTAAACCCAGC: TCGATAGGTAAACCCAGCT
AAGCGGGTGCCAGTCGCGG: AGCGGGTGCCAGTCGCGGT
AGATACAAATTCTTAACGC: GATACAAATTCTTAACGCG
GTGCGCGGGAAAAGACTAC: TGCGCGGGAAAAGACTACG
GCACGGCAGAGATTAAAGC: CACGGCAGAGATTAAAGCG
AAAATGTTCAGGAGCTCAT: AAATGTTCAGGAGCTCATG
TATCGTGCCGGCATATCCA: ATCGTGCCGGCATATCCAA
AGTGACGGGGGTATACATG: GTGACGGGGGTATACATGA
AAGACCGCAAAGCGGGTGC: AGACCGCAAAGCGGGTGCC
TACGTTGTAGGCGAGGCTA: ACGTTGTAGGCGAGGCTAG
TCAGCCCTTTTTCTCGTAA: CAGCCCTTTTTCTCGTAAG
CATATTTCTCACGCGGTCG: ATATTTCTCACGCGGTCGC
GCAACCCAGCGTAAACTTT: CAACCCAGCGTAAACTTTG
CTGTTGCACGTATAACATG: TGTTGCACGTATAACATGC
AGTTGCACCGCCTCGCGAT: GTTGCACCGCCTCGCGATT
TTCAACTATAATAATCCGT: TCAACTATAATAATCCGTC
CCTTTATAGATTTGTAGAA: CTTTATAGATTTGTAGAAT
TTGCACGTATAACATGCCT: TGCACGTATAACATGCCTC
GATCTCACAAAGCATCTTA: ATCTCACAAAGCATCTTAC
CGTTTAGTGACGGGGGTAT: GTTTAGTGACGGGGGTATA
CTCCATTTCCTTGGGGTGC: TCCATTTCCTTGGGGTGCC
CAGATCGATGTCCGCACAC: AGATCGATGTCCGCACACA
GCCTCGTCAACGGCAACCC: CCTCGTCAACGGCAACCCA
TCTGACACAGGAAGTAAAC: CTGACACAGGAAGTAAACT
CAATTGGTCCGTGCGCGGG: AATTGGTCCGTGCGCGGGA
GTCCTTCTTCCGCTTCAAG: TCCTTCTTCCGCTTCAAGA
GAGAAATACCTGCGCAGTA: AGAAATACCTGCGCAGTAC
GAAGGTACTCGCAATGCCT: AAGGTACTCGCAATGCCTC
ATAGGTAAACCCAGCTATT: TAGGTAAACCCAGCTATTG
AAGCTTACGAGTCGAGAAA: AGCTTACGAGTCGAGAAAT
ACTGTGACTCTGCTTGAGC: CTGTGACTCTGCTTGAGCT
TAACATGCCTCGGGAAATT: AACATGCCTCGGGAAATTG
TCTTAACGCGTAGCAGGTC: CTTAACGCGTAGCAGGTCA
TGATATACAAGGCAAAAAG: GATATACAAGGCAAAAAGG
CTCGTGGACCTGGAGTCCC: TCGTGGACCTGGAGTCCCA
TATAACATGCCTCGGGAAA: ATAACATGCCTCGGGAAAT
TAACGTTTAGTCGCGTCGC: AACGTTTAGTCGCGTCGCC
CCCCCCTAGGCTGCGTTGG: CCCCCTAGGCTGCGTTGGA
CATTGCCTCGTCAACGGCA: ATTGCCTCGTCAACGGCAA
ATTCACGCTTGTATCTTTG: TTCACGCTTGTATCTTTGG
TATCCTGATATACAAGGCA: ATCCTGATATACAAGGCAA
ATAGTGGACGCAAGCTTAC: TAGTGGACGCAAGCTTACG
CCCGTATGTGCCTGGCCGG: CCGTATGTGCCTGGCCGGC
TTTTGAGATCATTCTTAGA: TTTGAGATCATTCTTAGAT
CAGTCGCGGTAACATCAGC: AGTCGCGGTAACATCAGCC
CCCCGAAGGGGCACTGCTG: CCCGAAGGGGCACTGCTGA
CCCCTATTGCACAGGGAGC: CCCTATTGCACAGGGAGCG
CCGACACCAATTGGTCCGT: CGACACCAATTGGTCCGTG
GTGCCATATTTCTCACGCG: TGCCATATTTCTCACGCGG
CGCGTAATGCGGTCCGATC: GCGTAATGCGGTCCGATCA
GCGTTGCCAAGTGGAGTTG: CGTTGCCAAGTGGAGTTGA
GTTGGAGCTCGAATGTCAC: TTGGAGCTCGAATGTCACT
ACCCTCGTTAGAAAGGTTT: CCCTCGTTAGAAAGGTTTT
GGACTACTATATTATACGT: GACTACTATATTATACGTA
TTACCATCTGCATAAGACG: TACCATCTGCATAAGACGC
GCTGCCGCCTTCGGTTAAA: CTGCCGCCTTCGGTTAAAG
CAGCCCGGTGCTGCTGAGG: AGCCCGGTGCTGCTGAGGG
TTTTCTCGTAAGAGCCCGG: TTTCTCGTAAGAGCCCGGG
AAACTTTGGCACCAAGATA: AACTTTGGCACCAAGATAC
TATATTGTGGCCACCGAGG: ATATTGTGGCCACCGAGGC
CACTCTTCTTTACCCTCGT: ACTCTTCTTTACCCTCGTT
CGAAGGTACTCGCAATGCC: GAAGGTACTCGCAATGCCT
TATTCAACTATAATAATCC: ATTCAACTATAATAATCCG
GCCTGTCTGATAGAGAGGA: CCTGTCTGATAGAGAGGAG
AGGATCAAGTGGACTTTTA: GGATCAAGTGGACTTTTAA
TTGGCGTTGCCAAGTGGAG: TGGCGTTGCCAAGTGGAGT
GCGGGACCCTCGAGCTGAA: CGGGACCCTCGAGCTGAAG
GCGAGCAACATGTGTCTAA: CGAGCAACATGTGTCTAAT
GTTGCACGTATAACATGCC: TTGCACGTATAACATGCCT
CAACCCAGCGTAAACTTTG: AACCCAGCGTAAACTTTGG
TTTGGCCCCCCCTAGGCTG: TTGGCCCCCCCTAGGCTGC
TACTTTATGGATATGATTA: ACTTTATGGATATGATTAG
CGGCAACCCAGCGTAAACT: GGCAACCCAGCGTAAACTT
CTCAATGCCTGCAACCAAG: TCAATGCCTGCAACCAAGG
GCAGGAGACGTGCGCACTT: CAGGAGACGTGCGCACTTA
ATATGATTAGCCAGCTTCA: TATGATTAGCCAGCTTCAC
GGCAGAACCGGTAATACTG: GCAGAACCGGTAATACTGT
GACGCTGTTCAATTGGGCT: ACGCTGTTCAATTGGGCTG
GTCCGCACACAGCTAGTGA: TCCGCACACAGCTAGTGAG
ACGCAAGCTTACGAGTCGA: CGCAAGCTTACGAGTCGAG
AGCGTAAACTTTGGCACCA: GCGTAAACTTTGGCACCAA
TCACGCGGTCGCGGTTATA: CACGCGGTCGCGGTTATAT
CGGGATTGGTTCACGCTTG: GGGATTGGTTCACGCTTGT
TACGCCCGCGTTCGCAGTA: ACGCCCGCGTTCGCAGTAT
CAAAGTATCTTGGGTTGGA: AAAGTATCTTGGGTTGGAG
CCTACTTGGCGTTGCCAAG: CTACTTGGCGTTGCCAAGT
TCTCACGCGGTCGCGGTTA: CTCACGCGGTCGCGGTTAT
AGGGAAGCGCAGAGGATCA: GGGAAGCGCAGAGGATCAA
TTAAAGCGACGTGACGACG: TAAAGCGACGTGACGACGG
GAGCGACGAACACACAAGA: AGCGACGAACACACAAGAG
CTGCTGAGGGGTATCGTGC: TGCTGAGGGGTATCGTGCC
TGCTTGAGCTGCCCGTTAC: GCTTGAGCTGCCCGTTACG
ATCTTACTTTACCATCTGC: TCTTACTTTACCATCTGCA
GTGGACGCAAGCTTACGAG: TGGACGCAAGCTTACGAGT
ATTGTGGCCACCGAGGCTG: TTGTGGCCACCGAGGCTGC
GAAACCATTCTCAGGCAAG: AAACCATTCTCAGGCAAGG
GGCGCCATGCTGCCAGAAC: GCGCCATGCTGCCAGAACT
TTAGATATTTGGAACTATT: TAGATATTTGGAACTATTA
GGCAGTACTTTATGGATAT: GCAGTACTTTATGGATATG
TGCCTCGGGAAATTGGAGG: GCCTCGGGAAATTGGAGGC
AATCGCAGGGACTCAACAG: ATCGCAGGGACTCAACAGT
ATAATAATCCGTCTGAAAC: TAATAATCCGTCTGAAACC
ATTGAATACCAGTATTCTC: TTGAATACCAGTATTCTCC
CGCAGCTTTCTCCCGATCG: GCAGCTTTCTCCCGATCGA
TAGGTAGAGGTATGAACTG: AGGTAGAGGTATGAACTGG
GCTTGAGCTGCCCGTTACG: CTTGAGCTGCCCGTTACGG
TCTTCCGCTTCAAGAGTTG: CTTCCGCTTCAAGAGTTGT
TACACGACGCTGTTCAATT: ACACGACGCTGTTCAATTG
TGGATCTCGGCCGCTCGTA: GGATCTCGGCCGCTCGTAA
ATGTCTGGTCCAAAGTATC: TGTCTGGTCCAAAGTATCT
GTGTCTAATTGTCGGGACT: TGTCTAATTGTCGGGACTA
CTGTTCAATTGGGCTGGGG: TGTTCAATTGGGCTGGGGA
GGGTACTCATGAACTCGAA: GGTACTCATGAACTCGAAC
AGAGTTGTAGTTGCACCGC: GAGTTGTAGTTGCACCGCC
ACGCTTGTATCTTTGGCTT: CGCTTGTATCTTTGGCTTG
CAATGCCTGCAACCAAGGG: AATGCCTGCAACCAAGGGA
AAAACAGGTGCCTACTGCT: AAACAGGTGCCTACTGCTG
CGTAGCAGGTCAGACGGTG: GTAGCAGGTCAGACGGTGC
CACTTAAAATGTTCAGGAG: ACTTAAAATGTTCAGGAGC
ACGCTGTTCAATTGGGCTG: CGCTGTTCAATTGGGCTGG
CCTGCAACCAAGGGAACAT: CTGCAACCAAGGGAACATA
TATGTGCCTGGCCGGCGGT: ATGTGCCTGGCCGGCGGTT
GTAATGCGGTCCGATCACA: TAATGCGGTCCGATCACAA
CGCGTAGCAGGTCAGACGG: GCGTAGCAGGTCAGACGGT
CGGGACAGCTGCCGCCTTC: GGGACAGCTGCCGCCTTCG
CGCAAGCTTACGAGTCGAG: GCAAGCTTACGAGTCGAGA
AGGCTTTTAACCCACTGAT: GGCTTTTAACCCACTGATT
TGGATATGATTAGCCAGCT: GGATATGATTAGCCAGCTT
TGGTCCAAAGTATCTTGGG: GGTCCAAAGTATCTTGGGT
TTCGAGGTATGGATCTCGG: TCGAGGTATGGATCTCGGC
CTTTAGGGAAGCGCAGAGG: TTTAGGGAAGCGCAGAGGA
TGGGTACTCATGAACTCGA: GGGTACTCATGAACTCGAA
TGACGCCTCCCATACAACG: GACGCCTCCCATACAACGC
TCTTAGACGTTTGTAAGCC: CTTAGACGTTTGTAAGCCT
TTGTAAGCCTGTCTGATAG: TGTAAGCCTGTCTGATAGA
GCTTTAAAAAAAAACAGGT: CTTTAAAAAAAAACAGGTG
GCTTTCTCCCGATCGAAGG: CTTTCTCCCGATCGAAGGT
ATCTGTTGCACGTATAACA: TCTGTTGCACGTATAACAT
ATTATACGTACTGTGACTC: TTATACGTACTGTGACTCT
CTGGTTCCTTTATAGATTT: TGGTTCCTTTATAGATTTG
CGGGTTTTCTTTGGGTACT: GGGTTTTCTTTGGGTACTC
TACTCATCTTGATAAGGCG: ACTCATCTTGATAAGGCGA
TCATGCAGTACTTTATGGA: CATGCAGTACTTTATGGAT
CGATCACAAACTAACGTTT: GATCACAAACTAACGTTTA
CGCGTTCGCAGTATCCGGC: GCGTTCGCAGTATCCGGCG
CATCTTACTTTACCATCTG: ATCTTACTTTACCATCTGC
CGTAAACTTTGGCACCAAG: GTAAACTTTGGCACCAAGA
AAGACTACGAGCGCAGTAC: AGACTACGAGCGCAGTACT
TAGTCAAGGAATATGGCAT: AGTCAAGGAATATGGCATC
CGTTCGCAGTATCCGGCGC: GTTCGCAGTATCCGGCGCC
GCGTCGCCAACGAAATACA: CGTCGCCAACGAAATACAC
GCCGCTCGTAAACCAGTGG: CCGCTCGTAAACCAGTGGC
AAAAACAGGTGCCTACTGC: AAAACAGGTGCCTACTGCT
TTAGTCCTTCTTCCGCTTC: TAGTCCTTCTTCCGCTTCA
GTACTTTATGGATATTACG: TACTTTATGGATATTACGG
TAGAATTCATCGAGAACGC: AGAATTCATCGAGAACGCG
TCAAGAGTTGTAGTTGCAC: CAAGAGTTGTAGTTGCACC
AGCTGCCGCCTTCGGTTAA: GCTGCCGCCTTCGGTTAAA
TGATCTCACAAAGCATCTT: GATCTCACAAAGCATCTTA
CAGAGATTAAAGCGACGTG: AGAGATTAAAGCGACGTGA
AACCCAGCGTAAACTTTGG: ACCCAGCGTAAACTTTGGC
GAGCTATCCTGATATACAA: AGCTATCCTGATATACAAG
CTGCAACCAAGGGAACATA: TGCAACCAAGGGAACATAC
GGCAAAAAGGCGGTGTCAG: GCAAAAAGGCGGTGTCAGC
AAGCTCGTAAGTAACCCCG: AGCTCGTAAGTAACCCCGT
TTGTATCTTTGGCTTGATC: TGTATCTTTGGCTTGATCT
GTTTGTAAGCCTGTCTGAT: TTTGTAAGCCTGTCTGATA
CATCTGCATCTTGAACCTA: ATCTGCATCTTGAACCTAC
TGAGTGGCAGTTCTGACAC: GAGTGGCAGTTCTGACACA
ACAACGCCTCGTAGGTACT: CAACGCCTCGTAGGTACTC
TACTTAGGCAATCGCAGGG: ACTTAGGCAATCGCAGGGA
CAACGAAATACACGACGCT: AACGAAATACACGACGCTG
AAGGGCTGCCGTGAATACG: AGGGCTGCCGTGAATACGC
CGTAGTGGCCCTCCCCCGA: GTAGTGGCCCTCCCCCGAA
GTATTCAACTATAATAATC: TATTCAACTATAATAATCC
GCTTCAAGAGTTGTAGTTG: CTTCAAGAGTTGTAGTTGC
GAGATTAAAGCGACGTGAC: AGATTAAAGCGACGTGACG
GCTGCCGTGAATACGCCCG: CTGCCGTGAATACGCCCGC
TAAACCAGTGGCAGAACCG: AAACCAGTGGCAGAACCGG
CTGGCCGGCGGTTGCGGGA: TGGCCGGCGGTTGCGGGAG
CCTTGCATTGCCTCGCGTG: CTTGCATTGCCTCGCGTGA
ACTTTTCTGAGCGAGCGCG: CTTTTCTGAGCGAGCGCGT
CTAGGCTGCGTTGGAGCTC: TAGGCTGCGTTGGAGCTCG
GAACGCGACTAAATTGCGT: AACGCGACTAAATTGCGTT
CAGGGACTCAACAGTCGGG: AGGGACTCAACAGTCGGGC
CACGACGCTGTTCAATTGG: ACGACGCTGTTCAATTGGG
TTTCTGAGCGAGCGCGTAA: TTCTGAGCGAGCGCGTAAT
CAGTGGCAGAACCGGTAAT: AGTGGCAGAACCGGTAATA
CCAGTCGCGGTAACATCAG: CAGTCGCGGTAACATCAGC
AGGCAAAAAGGCGGTGTCA: GGCAAAAAGGCGGTGTCAG
GGGACTCAACAGTCGGGCA: GGACTCAACAGTCGGGCAT
GCTGATTATGGTGAGTGGC: CTGATTATGGTGAGTGGCA
TTGGGCTGGGGATCCTGGT: TGGGCTGGGGATCCTGGTA
GCACTGCTGATTATGGTGA: CACTGCTGATTATGGTGAG
GCTTGATCTCACAAAGCAT: CTTGATCTCACAAAGCATC
GACGACGGTGCCATATTTC: ACGACGGTGCCATATTTCT
CATTTCCTTGGGGTGCCAC: ATTTCCTTGGGGTGCCACC
GCACAGGGAGCGAGTCACA: CACAGGGAGCGAGTCACAA
GCGCACTTAGGTAGAGGTA: CGCACTTAGGTAGAGGTAT
GACCGCAAAGCGGGTGCCA: ACCGCAAAGCGGGTGCCAG
GTACTCATCTTGATAAGGC: TACTCATCTTGATAAGGCG
CGGGAAATTGGAGGCGGCG: GGGAAATTGGAGGCGGCGG
GAATACACTCTTCTTTACC: AATACACTCTTCTTTACCC
CTTTGGGCACGGTAAGTTG: TTTGGGCACGGTAAGTTGT
CTCATCTTGATAAGGCGAG: TCATCTTGATAAGGCGAGC
GTGAGTGGCAGTTCTGACA: TGAGTGGCAGTTCTGACAC
TACACTCTTCTTTACCCTC: ACACTCTTCTTTACCCTCG
AGGCAATCGCAGGGACTCA: GGCAATCGCAGGGACTCAA
GGAGACGTGCGCACTTAGG: GAGACGTGCGCACTTAGGT
ACGCCTCGTAGGTACTCAT: CGCCTCGTAGGTACTCATC
GGGTGCCAGTCGCGGTAAC: GGTGCCAGTCGCGGTAACA
GGATCCTGGTAACACAGAT: GATCCTGGTAACACAGATC
GTGAATACGCCCGCGTTCG: TGAATACGCCCGCGTTCGC
CTCGGGAAATTGGAGGCGG: TCGGGAAATTGGAGGCGGC
AGTACTTTATGGATATTAC: GTACTTTATGGATATTACG
AGGTTTTGAGATCATTCTT: GGTTTTGAGATCATTCTTA
ATCTGCATCTTGAACCTAC: TCTGCATCTTGAACCTACT
TCTCAGGCAAGGGCTGCCG: CTCAGGCAAGGGCTGCCGT
CCAGCGTAAACTTTGGCAC: CAGCGTAAACTTTGGCACC
TCAAGGAATATGGCATCCT: CAAGGAATATGGCATCCTC
ACCGCCTCGCGATTGTACT: CCGCCTCGCGATTGTACTT
TTGGCACCAAGATACAAAT: TGGCACCAAGATACAAATT
AAGCCTGTCTGATAGAGAG: AGCCTGTCTGATAGAGAGG
CACAATCTGTTGCACGTAT: ACAATCTGTTGCACGTATA
AGTCCGGGCTTTAAAAAAA: GTCCGGGCTTTAAAAAAAA
ACTTTTAAGACCGCAAAGC: CTTTTAAGACCGCAAAGCG
GCCCTCCCCCGAAGGGGCA: CCCTCCCCCGAAGGGGCAC
TGTTCAATTGGGCTGGGGA: GTTCAATTGGGCTGGGGAT
TGTAGTTGCACCGCCTCGC: GTAGTTGCACCGCCTCGCG
ATTGGAGGCGGCGGGACCC: TTGGAGGCGGCGGGACCCT
TTTATGGATATCTTGCAGC: TTATGGATATCTTGCAGCT
CTGGTCCAAAGTATCTTGG: TGGTCCAAAGTATCTTGGG
CTTTTTCTCGTAAGAGCCC: TTTTTCTCGTAAGAGCCCG
AAACTCGATAGGTAAACCC: AACTCGATAGGTAAACCCA
AAGAGCCCGGGACAGCTGC: AGAGCCCGGGACAGCTGCC
TTTAGTCGCGTCGCCAACG: TTAGTCGCGTCGCCAACGA
GTGATGCTATAAAAGCAGC: TGATGCTATAAAAGCAGCC
TAGTCCGGGCTTTAAAAAA: AGTCCGGGCTTTAAAAAAA
GCGCGTAATGCGGTCCGAT: CGCGTAATGCGGTCCGATC
CCATGTACTTTTCTGAGCG: CATGTACTTTTCTGAGCGA
AGGCGAGCAGGAGACGTGC: GGCGAGCAGGAGACGTGCG
AGTATCCGGCGCCGACACC: GTATCCGGCGCCGACACCA
TTAAGACCGCAAAGCGGGT: TAAGACCGCAAAGCGGGTG
TACCATTCAACATGTATTG: ACCATTCAACATGTATTGG
TATTAACTGGTTCCTTTAT: ATTAACTGGTTCCTTTATA
CGCTTGTATCTTTGGGCAC: GCTTGTATCTTTGGGCACG
AGCGAGTCACAATCTGTTG: GCGAGTCACAATCTGTTGC
TGATAAGGCGAGCAGGAGA: GATAAGGCGAGCAGGAGAC
CCTTCTTCCGCTTCAAGAG: CTTCTTCCGCTTCAAGAGT
AAAGACTACGAGCGCAGTA: AAGACTACGAGCGCAGTAC
GACCCTCGAGCTGAAGAAC: ACCCTCGAGCTGAAGAACT
GCGGGAGCGACGAACACAC: CGGGAGCGACGAACACACA
ATACAAGGCAAAAAGGCGG: TACAAGGCAAAAAGGCGGT
TGTATCTTTGGGCACGGTA: GTATCTTTGGGCACGGTAA
CTCGCGTGAATACACTCTT: TCGCGTGAATACACTCTTC
CAGCAGCAGTACTTTATGG: AGCAGCAGTACTTTATGGA
TGATTAGCCAGCTTCACGC: GATTAGCCAGCTTCACGCT
TGGCAGTTCTGACACAGGA: GGCAGTTCTGACACAGGAA
CTTTTAAGACCGCAAAGCG: TTTTAAGACCGCAAAGCGG
TCGAAGGTACTCGCAATGC: CGAAGGTACTCGCAATGCC
AGACTACGAGCGCAGTACT: GACTACGAGCGCAGTACTT
TGCATCTTGAACCTACTTG: GCATCTTGAACCTACTTGG
AACATGCCTCGGGAAATTG: ACATGCCTCGGGAAATTGG
TCATCGAGAACGCGACTAA: CATCGAGAACGCGACTAAA
GAACTCGAACTCGTTGCAC: AACTCGAACTCGTTGCACG
TGCTGATTATGGTGAGTGG: GCTGATTATGGTGAGTGGC
TAATGCGGTCCGATCACAA: AATGCGGTCCGATCACAAA
AAAAAAACAGGTGCCTACT: AAAAAACAGGTGCCTACTG
TTGAACCTACTTGGCGTTG: TGAACCTACTTGGCGTTGC
GATATACAAGGCAAAAAGG: ATATACAAGGCAAAAAGGC
TCACGCTTGTATCTTTGGC: CACGCTTGTATCTTTGGCG CACGCTTGTATCTTTGGCT CACGCTTGTATCTTTGGCC
AGGCTGCGTTGGAGCTCGA: GGCTGCGTTGGAGCTCGAA
GGGATCCTGGTAACACAGA: GGATCCTGGTAACACAGAT
GCTTGTATCTTTGGGCACG: CTTGTATCTTTGGGCACGG
TCCTTCTTCCGCTTCAAGA: CCTTCTTCCGCTTCAAGAG
GTAGGTACTCATCTTGATA: TAGGTACTCATCTTGATAA
GCTCGTAAACCAGTGGCAG: CTCGTAAACCAGTGGCAGA
CTGCTGTCGAGGTACACCC: TGCTGTCGAGGTACACCCC
CTCAGGCAAGGGCTGCCGT: TCAGGCAAGGGCTGCCGTG
GCCTCGGGGTTCTTCGAGG: CCTCGGGGTTCTTCGAGGT
AATAATCCGTCTGAAACCA: ATAATCCGTCTGAAACCAT
TCCAAAGTATCTTGGGTTG: CCAAAGTATCTTGGGTTGG
ATAGTCCGGGCTTTAAAAA: TAGTCCGGGCTTTAAAAAA
GAACCGGTAATACTGTAGG: AACCGGTAATACTGTAGGG
ACAAGAGCCAATCTATAGT: CAAGAGCCAATCTATAGTG
TCTTACTTTACCATCTGCA: CTTACTTTACCATCTGCAT
CGGCATATCCAAGTCTTAG: GGCATATCCAAGTCTTAGA
TCTGCCATAGTCAAGGAAT: CTGCCATAGTCAAGGAATA
ATCCTGATATACAAGGCAA: TCCTGATATACAAGGCAAA
GATATAGGCCAGTCTATTC: ATATAGGCCAGTCTATTCA
CAATCTGTTGCACGTATAA: AATCTGTTGCACGTATAAC
TACAAATTCTTAACGCGTA: ACAAATTCTTAACGCGTAG
TCCGATCACAAACTAACGT: CCGATCACAAACTAACGTT
GTATACATGATCTGGCGCC: TATACATGATCTGGCGCCA
ATGGATCTCGGCCGCTCGT: TGGATCTCGGCCGCTCGTA
CTGAAGAACTTTAGGGAAG: TGAAGAACTTTAGGGAAGC
TCTTTACCCTCGTTAGAAA: CTTTACCCTCGTTAGAAAG
TTGGTCCATGTACTTTTCT: TGGTCCATGTACTTTTCTG
CGAGAACGCGACTAAATTG: GAGAACGCGACTAAATTGC
CACAAAGCATCTTACTTTA: ACAAAGCATCTTACTTTAC
GTAGAGGTATGAACTGGGA: TAGAGGTATGAACTGGGAG
CTGCTTGAGCTGCCCGTTA: TGCTTGAGCTGCCCGTTAC
AGTTCTGACACAGGAAGTA: GTTCTGACACAGGAAGTAA
TCAACGGCAACCCAGCGTA: CAACGGCAACCCAGCGTAA
ACGTGCGCACTTAGGTAGA: CGTGCGCACTTAGGTAGAG
TATAGTGGACGCAAGCTTA: ATAGTGGACGCAAGCTTAC
ATTGTACTTAGGCAATCGC: TTGTACTTAGGCAATCGCA
TGTATCTTTGGCCCCCCCT: GTATCTTTGGCCCCCCCTA
AAAGGTTTTGAGATCATTC: AAGGTTTTGAGATCATTCT
TGACACAGGAAGTAAACTC: GACACAGGAAGTAAACTCG
ACAGCTAGTGAGAGGCTAC: CAGCTAGTGAGAGGCTACC
TGAACTGGGAGGCTTTTAA: GAACTGGGAGGCTTTTAAC
TACTTTATGGATATTACGG: ACTTTATGGATATTACGGG
TATCTTTGGGCACGGTAAG: ATCTTTGGGCACGGTAAGT
TTTAAGACCGCAAAGCGGG: TTAAGACCGCAAAGCGGGT
CTGCGCAGTACGTTGTAGG: TGCGCAGTACGTTGTAGGC
AGTCGCGGTAACATCAGCC: GTCGCGGTAACATCAGCCC
GTCCGGGCTTTAAAAAAAA: TCCGGGCTTTAAAAAAAAA
GCCAACGAAATACACGACG: CCAACGAAATACACGACGC
AGATATTTGGAACTATTAA: GATATTTGGAACTATTAAC
GAGTCGAGAAATACCTGCG: AGTCGAGAAATACCTGCGC
ATAAGCTCGTAAGTAACCC: TAAGCTCGTAAGTAACCCC
GTACTCATGAACTCGAACT: TACTCATGAACTCGAACTC
CAGTACTTTATGGATATGA: AGTACTTTATGGATATGAT
GAACTGGGAGGCTTTTAAC: AACTGGGAGGCTTTTAACC
TTTACCATCTGCATAAGAC: TTACCATCTGCATAAGACG
GGCTGGGGATCCTGGTAAC: GCTGGGGATCCTGGTAACA
TGTAAGCCTGTCTGATAGA: GTAAGCCTGTCTGATAGAG
GTAAGCCTGTCTGATAGAG: TAAGCCTGTCTGATAGAGA
CGTCTGAAACCATTCTCAG: GTCTGAAACCATTCTCAGG
AGATCGATGTCCGCACACA: GATCGATGTCCGCACACAG
TTATAGATTTGTAGAATTC: TATAGATTTGTAGAATTCA
GTTATATTGTGGCCACCGA: TTATATTGTGGCCACCGAG
ATCTTTGGCTTGATCTCAC: TCTTTGGCTTGATCTCACA
ACGTATAACATGCCTCGGG: CGTATAACATGCCTCGGGA
CCGCTCGTAAACCAGTGGC: CGCTCGTAAACCAGTGGCA
GCAGTACTTTATGGATATC: CAGTACTTTATGGATATCT
TTAAAATGTTCAGGAGCTC: TAAAATGTTCAGGAGCTCA
CCGCCTTCGGTTAAAGGTG: CGCCTTCGGTTAAAGGTGT
ACACAGATCGATGTCCGCA: CACAGATCGATGTCCGCAC
AAGGCAAAAAGGCGGTGTC: AGGCAAAAAGGCGGTGTCA
TATTGGTCCATGTACTTTT: ATTGGTCCATGTACTTTTC
CGACGGTGCCATATTTCTC: GACGGTGCCATATTTCTCA
CGCAGTATCCGGCGCCGAC: GCAGTATCCGGCGCCGACA
GGATATTACGGGATTGGTT: GATATTACGGGATTGGTTC
CCTCGCGTGAATACACTCT: CTCGCGTGAATACACTCTT
ATGTCCGCACACAGCTAGT: TGTCCGCACACAGCTAGTG
TTGTAGTTGCACCGCCTCG: TGTAGTTGCACCGCCTCGC
AGAGGATCAAGTGGACTTT: GAGGATCAAGTGGACTTTT
ATGTGTCTAATTGTCGGGA: TGTGTCTAATTGTCGGGAC
TGCTGTCGAGGTACACCCC: GCTGTCGAGGTACACCCCC
ACACAGCAGCAGTACTTTA: CACAGCAGCAGTACTTTAT
GGGTATACATGATCTGGCG: GGTATACATGATCTGGCGC
TCCCATACAACGCCTCGTA: CCCATACAACGCCTCGTAG
GGCGCATCTGCATCTTGAA: GCGCATCTGCATCTTGAAC
GTTCTGACACAGGAAGTAA: TTCTGACACAGGAAGTAAA
TGAACTCGAACTCGTTGCA: GAACTCGAACTCGTTGCAC
CTATTGCACAGGGAGCGAG: TATTGCACAGGGAGCGAGT
CTGAAACCATTCTCAGGCA: TGAAACCATTCTCAGGCAA
ATTCGGGTTTTCTTTGGGT: TTCGGGTTTTCTTTGGGTA
TCATCTTGATAAGGCGAGC: CATCTTGATAAGGCGAGCA
TCAGGAGCTCATGCAGTAC: CAGGAGCTCATGCAGTACT
CAAGGAATATGGCATCCTC: AAGGAATATGGCATCCTCA
GCATCTGCATCTTGAACCT: CATCTGCATCTTGAACCTA
AAGTAACCCCGTATGTGCC: AGTAACCCCGTATGTGCCT
ATATACAAGGCAAAAAGGC: TATACAAGGCAAAAAGGCG
CTTAGGTAGAGGTATGAAC: TTAGGTAGAGGTATGAACT
CGGTGCCATATTTCTCACG: GGTGCCATATTTCTCACGC
ATAATCCGTCTGAAACCAT: TAATCCGTCTGAAACCATT
GTGTCAGCTTAGTCCTTCT: TGTCAGCTTAGTCCTTCTT
CAACGGCAACCCAGCGTAA: AACGGCAACCCAGCGTAAA
CCGTGCGCGGGAAAAGACT: CGTGCGCGGGAAAAGACTA
AGAACCGGTAATACTGTAG: GAACCGGTAATACTGTAGG
GGCATCCTCAATGCCTGCA: GCATCCTCAATGCCTGCAA
CCATTGCCTCGTCAACGGC: CATTGCCTCGTCAACGGCA
TGGCCCTCCCCCGAAGGGG: GGCCCTCCCCCGAAGGGGC
ATCACAAACTAACGTTTAG: TCACAAACTAACGTTTAGT
TGCCGCCTTCGGTTAAAGG: GCCGCCTTCGGTTAAAGGT
AGGAGCTCATGCAGTACTT: GGAGCTCATGCAGTACTTT
GCCCTTTTTCTCGTAAGAG: CCCTTTTTCTCGTAAGAGC
AATACGCCCGCGTTCGCAG: ATACGCCCGCGTTCGCAGT
TGTCTGGTCCAAAGTATCT: GTCTGGTCCAAAGTATCTT
CAGTTCTGACACAGGAAGT: AGTTCTGACACAGGAAGTA
CGCTCGTAAACCAGTGGCA: GCTCGTAAACCAGTGGCAG
CGGCAGAGATTAAAGCGAC: GGCAGAGATTAAAGCGACG
CGCGACTAAATTGCGTTTA: GCGACTAAATTGCGTTTAG
GATCATTCTTAGATATTTG: ATCATTCTTAGATATTTGG
GCACCGCCTCGCGATTGTA: CACCGCCTCGCGATTGTAC
CTAAATTGCGTTTAGTGAC: TAAATTGCGTTTAGTGACG
AGTCTTAGACGTTTGTAAG: GTCTTAGACGTTTGTAAGC
AAGTATCTTGGGTTGGAGA: AGTATCTTGGGTTGGAGAC
CACCAAGATACAAATTCTT: ACCAAGATACAAATTCTTA
AAAAGCAGCCCGGTGCTGC: AAAGCAGCCCGGTGCTGCT
TATAGGCCAGTCTATTCAC: ATAGGCCAGTCTATTCACG
GGATCTCGGCCGCTCGTAA: GATCTCGGCCGCTCGTAAA
GCTGAAGAACTTTAGGGAA: CTGAAGAACTTTAGGGAAG
CAACATGTATTGGCGTCGC: AACATGTATTGGCGTCGCC
CGGTAATACTGTAGGGATG: GGTAATACTGTAGGGATGT
CGCCTCGTAGGTACTCATC: GCCTCGTAGGTACTCATCT
GCATCCTCAATGCCTGCAA: CATCCTCAATGCCTGCAAC
GGCGGCGGGACCCTCGAGC: GCGGCGGGACCCTCGAGCT
CAAACTAACGTTTAGTCGC: AAACTAACGTTTAGTCGCG
GTGCCGGCATATCCAAGTC: TGCCGGCATATCCAAGTCT
TAGAAAGGTTTTGAGATCA: AGAAAGGTTTTGAGATCAT
AGGTATGAACTGGGAGGCT: GGTATGAACTGGGAGGCTT
TTCAATTGGGCTGGGGATC: TCAATTGGGCTGGGGATCC
CATCAGCCCTTTTTCTCGT: ATCAGCCCTTTTTCTCGTA
TAACCCACTGATTCGGGTT: AACCCACTGATTCGGGTTT
AGGAAGTAAACTCGATAGG: GGAAGTAAACTCGATAGGT
TGTATCTTTGGCTTGATCT: GTATCTTTGGCTTGATCTC
AGTACTTTATGGATATCTT: GTACTTTATGGATATCTTG
CAGGTGCCTACTGCTGTCG: AGGTGCCTACTGCTGTCGA
CTCGTAAGAGCCCGGGACA: TCGTAAGAGCCCGGGACAG
AAACTAACGTTTAGTCGCG: AACTAACGTTTAGTCGCGT
CAAGTGGAGTTGAGTGACG: AAGTGGAGTTGAGTGACGC
GGGATTGGTTCACGCTTGT: GGATTGGTTCACGCTTGTA
GCCCGGGACAGCTGCCGCC: CCCGGGACAGCTGCCGCCT
CAGAACCGGTAATACTGTA: AGAACCGGTAATACTGTAG
GTCGCGGTAACATCAGCCC: TCGCGGTAACATCAGCCCT
CCAAGTCTTAGACGTTTGT: CAAGTCTTAGACGTTTGTA
TTGGCGTCGCCCACGGAGC: TGGCGTCGCCCACGGAGCT
TCTTGAACCTACTTGGCGT: CTTGAACCTACTTGGCGTT
GGCCGGCGGTTGCGGGAGC: GCCGGCGGTTGCGGGAGCG
TGGGTTGGAGACACAGCAG: GGGTTGGAGACACAGCAGC
GTTGTAGGCGAGGCTAGCG: TTGTAGGCGAGGCTAGCGG
GCATAAGACGCAGCTTTCT: CATAAGACGCAGCTTTCTC
AAATTCTTAACGCGTAGCA: AATTCTTAACGCGTAGCAG
CTTTACCATCTGCATAAGA: TTTACCATCTGCATAAGAC
GTCGAGAAATACCTGCGCA: TCGAGAAATACCTGCGCAG
ATACCAGTATTCTCCATTT: TACCAGTATTCTCCATTTC
GGAGGCGGCGGGACCCTCG: GAGGCGGCGGGACCCTCGA
GTGCCTACTGCTGTCGAGG: TGCCTACTGCTGTCGAGGT
GGTTCCTTTATAGATTTGT: GTTCCTTTATAGATTTGTA
TCCCATTGCCTCGTCAACG: CCCATTGCCTCGTCAACGG
CGTTGGAGCTCGAATGTCA: GTTGGAGCTCGAATGTCAC
GAGAGGCTACCATTCAACA: AGAGGCTACCATTCAACAT
ACACAGCTAGTGAGAGGCT: CACAGCTAGTGAGAGGCTA
TAAAAGCAGCCCGGTGCTG: AAAAGCAGCCCGGTGCTGC
TATATTATACGTACTGTGA: ATATTATACGTACTGTGAC
ATTTCCTTGGGGTGCCACC: TTTCCTTGGGGTGCCACCT
TACAAGGCAAAAAGGCGGT: ACAAGGCAAAAAGGCGGTG
GAGGCGGCGGGACCCTCGA: AGGCGGCGGGACCCTCGAG
CCCGAAGGGGCACTGCTGA: CCGAAGGGGCACTGCTGAT
ATACCTGCGCAGTACGTTG: TACCTGCGCAGTACGTTGT
GTGCGAGCAACATGTGTCT: TGCGAGCAACATGTGTCTA
AGGCTAGCGGTCGTGATGC: GGCTAGCGGTCGTGATGCT
AGCTAGTGAGAGGCTACCA: GCTAGTGAGAGGCTACCAT
ACGGCAGAGATTAAAGCGA: CGGCAGAGATTAAAGCGAC
ATGTATTGGCGTCGCCCAC: TGTATTGGCGTCGCCCACG
CTCGTCAACGGCAACCCAG: TCGTCAACGGCAACCCAGC
TCTTCTTTACCCTCGTTAG: CTTCTTTACCCTCGTTAGA
CATCTTGAACCTACTTGGC: ATCTTGAACCTACTTGGCG
GATGTCCGCACACAGCTAG: ATGTCCGCACACAGCTAGT
GAGACGTGCGCACTTAGGT: AGACGTGCGCACTTAGGTA
ATCGATGTCCGCACACAGC: TCGATGTCCGCACACAGCT
CGTGATGCTATAAAAGCAG: GTGATGCTATAAAAGCAGC
AGAGGTATGAACTGGGAGG: GAGGTATGAACTGGGAGGC
GCAAGCTTACGAGTCGAGA: CAAGCTTACGAGTCGAGAA
GGCTGCCGTGAATACGCCC: GCTGCCGTGAATACGCCCG
AACACAGATCGATGTCCGC: ACACAGATCGATGTCCGCA
TCATTCTTAGATATTTGGA: CATTCTTAGATATTTGGAA
AGTAAACTCGATAGGTAAA: GTAAACTCGATAGGTAAAC
CGGCGGTTGCGGGAGCGAC: GGCGGTTGCGGGAGCGACG
TTAGAAAGGTTTTGAGATC: TAGAAAGGTTTTGAGATCA
GGAGTCCCATTGCCTCGTC: GAGTCCCATTGCCTCGTCA
GGCGAGGCTAGCGGTCGTG: GCGAGGCTAGCGGTCGTGA
CTGTCTGATAGAGAGGAGT: TGTCTGATAGAGAGGAGTG
CCCCCCCTAGGCTGCGTTG: CCCCCCTAGGCTGCGTTGG
CATGCCTCGGGAAATTGGA: ATGCCTCGGGAAATTGGAG
TCTTCACGCTTGTATCTTT: CTTCACGCTTGTATCTTTG
AAATACACGACGCTGTTCA: AATACACGACGCTGTTCAA
ATTTCTCACGCGGTCGCGG: TTTCTCACGCGGTCGCGGT
CGGTCGCGGTTATATTGTG: GGTCGCGGTTATATTGTGG
AGCCCGGTGCTGCTGAGGG: GCCCGGTGCTGCTGAGGGG
GGGCACGGTAAGTTGTATA: GGCACGGTAAGTTGTATAA
TGAAGAACTTTAGGGAAGC: GAAGAACTTTAGGGAAGCG
TATCCAAGTCTTAGACGTT: ATCCAAGTCTTAGACGTTT
TTGTATCTTTGGCCCCCCC: TGTATCTTTGGCCCCCCCT
TACCCTCGTTAGAAAGGTT: ACCCTCGTTAGAAAGGTTT
CGTTGTAGGCGAGGCTAGC: GTTGTAGGCGAGGCTAGCG
TCGCAATGCCTCGGGGTTC: CGCAATGCCTCGGGGTTCT
AAAAGACTACGAGCGCAGT: AAAGACTACGAGCGCAGTA
TACTTTATGGATATCTTGC: ACTTTATGGATATCTTGCA
CTATAATAATCCGTCTGAA: TATAATAATCCGTCTGAAA
TGGCGTTGCCAAGTGGAGT: GGCGTTGCCAAGTGGAGTT
GACTCAACAGTCGGGCATA: ACTCAACAGTCGGGCATAG
GGTTATATTGTGGCCACCG: GTTATATTGTGGCCACCGA
CAAAAAGGCGGTGTCAGCT: AAAAAGGCGGTGTCAGCTT
TGAGATCATTCTTAGATAT: GAGATCATTCTTAGATATT
GGACCTGGAGTCCCATTGC: GACCTGGAGTCCCATTGCC
ACTGTAGGGATGTCTGGTC: CTGTAGGGATGTCTGGTCC
CAGCTTCACGCTTGTATCT: AGCTTCACGCTTGTATCTT
TAAATTGCGTTTAGTGACG: AAATTGCGTTTAGTGACGG
TGCCAGTCGCGGTAACATC: GCCAGTCGCGGTAACATCA
GTCACTTAAAATGTTCAGG: TCACTTAAAATGTTCAGGA
GCCCACGGAGCTATCCTGA: CCCACGGAGCTATCCTGAT
AGCTTCTTCACGCTTGTAT: GCTTCTTCACGCTTGTATC
GCAGTACTTTATGGATATT: CAGTACTTTATGGATATTA
GACGTTTGTAAGCCTGTCT: ACGTTTGTAAGCCTGTCTG
GGCTACCATTCAACATGTA: GCTACCATTCAACATGTAT
TAATACTGTAGGGATGTCT: AATACTGTAGGGATGTCTG
AATACACTCTTCTTTACCC: ATACACTCTTCTTTACCCT
CGTGAATACGCCCGCGTTC: GTGAATACGCCCGCGTTCG
GGTATGAACTGGGAGGCTT: GTATGAACTGGGAGGCTTT
ATCATAAGCTCGTAAGTAA: TCATAAGCTCGTAAGTAAC
CACTGCTGATTATGGTGAG: ACTGCTGATTATGGTGAGT
AGCTATCCTGATATACAAG: GCTATCCTGATATACAAGG
AGCTGAAGAACTTTAGGGA: GCTGAAGAACTTTAGGGAA
GAACACACAAGAGCCAATC: AACACACAAGAGCCAATCT
CCAAAGTATCTTGGGTTGG: CAAAGTATCTTGGGTTGGA
CGGCCGCTCGTAAACCAGT: GGCCGCTCGTAAACCAGTG
CATAAGACGCAGCTTTCTC: ATAAGACGCAGCTTTCTCC
GCGTCGCCCACGGAGCTAT: CGTCGCCCACGGAGCTATC
CGAGCTGAAGAACTTTAGG: GAGCTGAAGAACTTTAGGG
TTGGAACTATTAACTGGTT: TGGAACTATTAACTGGTTC
GCAATGCCTCGGGGTTCTT: CAATGCCTCGGGGTTCTTC
CCTTCGGTTAAAGGTGTAT: CTTCGGTTAAAGGTGTATT
CTACGAGCGCAGTACTTTA: TACGAGCGCAGTACTTTAT
GGCTTTAAAAAAAAACAGG: GCTTTAAAAAAAAACAGGT
ACTATATTATACGTACTGT: CTATATTATACGTACTGTG
CTCGGCCGCTCGTAAACCA: TCGGCCGCTCGTAAACCAG
TAAGAGCCCGGGACAGCTG: AAGAGCCCGGGACAGCTGC
CTCGTTGCACGGCAGAGAT: TCGTTGCACGGCAGAGATT
GGCCCCCCCTAGGCTGCGT: GCCCCCCCTAGGCTGCGTT
CTTGTATCTTTGGCCCCCC: TTGTATCTTTGGCCCCCCC
GACTTTTAAGACCGCAAAG: ACTTTTAAGACCGCAAAGC
GAGTTGTAGTTGCACCGCC: AGTTGTAGTTGCACCGCCT
CCCCCTATTGCACAGGGAG: CCCCTATTGCACAGGGAGC
GGCTGCGTTGGAGCTCGAA: GCTGCGTTGGAGCTCGAAT
TGCAGTACTTTATGGATAT: GCAGTACTTTATGGATATT
GTTAGAAAGGTTTTGAGAT: TTAGAAAGGTTTTGAGATC
TTATGGATATAGGCCAGTC: TATGGATATAGGCCAGTCT
TATGGATATCTTGCAGCTT: ATGGATATCTTGCAGCTTC
CGTAATGCGGTCCGATCAC: GTAATGCGGTCCGATCACA
TGATCTGGCGCCATGCTGC: GATCTGGCGCCATGCTGCC
TAAACTTTGGCACCAAGAT: AAACTTTGGCACCAAGATA
TCCCGATCGAAGGTACTCG: CCCGATCGAAGGTACTCGC
CTTGTATCTTTGGCTTGAT: TTGTATCTTTGGCTTGATC
TCGGGCATAGTCCGGGCTT: CGGGCATAGTCCGGGCTTT
TGAGTGACGCCTCCCATAC: GAGTGACGCCTCCCATACA
TTCTTTACCCTCGTTAGAA: TCTTTACCCTCGTTAGAAA
TTGGAGACACAGCAGCAGT: TGGAGACACAGCAGCAGTA
CTTTAAAAAAAAACAGGTG: TTTAAAAAAAAACAGGTGC
CTTAGTCCTTCTTCCGCTT: TTAGTCCTTCTTCCGCTTC
GAGGTATGAACTGGGAGGC: AGGTATGAACTGGGAGGCT
TTGTCGGGACTACTATATT: TGTCGGGACTACTATATTA
GCTGCCCGTTACGGACCCC: CTGCCCGTTACGGACCCCA
AGAGCCCGGGACAGCTGCC: GAGCCCGGGACAGCTGCCG
CACGTATAACATGCCTCGG: ACGTATAACATGCCTCGGG
TCTCACAAAGCATCTTACT: CTCACAAAGCATCTTACTT
AGTCGAGAAATACCTGCGC: GTCGAGAAATACCTGCGCA
CCGGCATATCCAAGTCTTA: CGGCATATCCAAGTCTTAG
ATTGCACAGGGAGCGAGTC: TTGCACAGGGAGCGAGTCA
CCGGGCTTTAAAAAAAAAC: CGGGCTTTAAAAAAAAACA
TTTTAAGACCGCAAAGCGG: TTTAAGACCGCAAAGCGGG
GTTCACGCTTGTATCTTTG: TTCACGCTTGTATCTTTGG
TATGGATATAGGCCAGTCT: ATGGATATAGGCCAGTCTA
GTAAACCCAGCTATTGAAT: TAAACCCAGCTATTGAATA
ATACGTACTGTGACTCTGC: TACGTACTGTGACTCTGCT
GCTTGTATCTTTGGCGCAT: CTTGTATCTTTGGCGCATC
TTCAAGAGTTGTAGTTGCA: TCAAGAGTTGTAGTTGCAC
TTTATGGATATGATTAGCC: TTATGGATATGATTAGCCA
GCCAGAACTATTGGTCCAT: CCAGAACTATTGGTCCATG
AACCCACTGATTCGGGTTT: ACCCACTGATTCGGGTTTT
CCCTCCCCCGAAGGGGCAC: CCTCCCCCGAAGGGGCACT
TCACGCTTGTATCTTTGGG: CACGCTTGTATCTTTGGGC
TGGAACTATTAACTGGTTC: GGAACTATTAACTGGTTCC
CTGGCGCCATGCTGCCAGA: TGGCGCCATGCTGCCAGAA
GCGGGTGCCAGTCGCGGTA: CGGGTGCCAGTCGCGGTAA
GCCATAGTCAAGGAATATG: CCATAGTCAAGGAATATGG
AAATACCTGCGCAGTACGT: AATACCTGCGCAGTACGTT
CACACAAGAGCCAATCTAT: ACACAAGAGCCAATCTATA
CATAGTCCGGGCTTTAAAA: ATAGTCCGGGCTTTAAAAA
CCACTGATTCGGGTTTTCT: CACTGATTCGGGTTTTCTT
ACTCGTTGCACGGCAGAGA: CTCGTTGCACGGCAGAGAT
CATGTACTTTTCTGAGCGA: ATGTACTTTTCTGAGCGAG
GCTGCCCTCTGCCATAGTC: CTGCCCTCTGCCATAGTCA
AAGCAGCCCGGTGCTGCTG: AGCAGCCCGGTGCTGCTGA
AGCCAGCTTCACGCTTGTA: GCCAGCTTCACGCTTGTAT
TAAGTAACCCCGTATGTGC: AAGTAACCCCGTATGTGCC
ACGCTTGTATCTTTGGGCA: CGCTTGTATCTTTGGGCAC
AATTGGGCTGGGGATCCTG: ATTGGGCTGGGGATCCTGG
GTGGCAGAACCGGTAATAC: TGGCAGAACCGGTAATACT
ATCCGGCGCCGACACCAAT: TCCGGCGCCGACACCAATT
AGAAAGGTTTTGAGATCAT: GAAAGGTTTTGAGATCATT
TGTAGGCGAGGCTAGCGGT: GTAGGCGAGGCTAGCGGTC
CTTTGGCCCCCCCTAGGCT: TTTGGCCCCCCCTAGGCTG
CACCTAGTACCTTGCATTG: ACCTAGTACCTTGCATTGC
TGATTCGGGTTTTCTTTGG: GATTCGGGTTTTCTTTGGG
GAGAACGCGACTAAATTGC: AGAACGCGACTAAATTGCG
TTTATGGATATTACGGGAT: TTATGGATATTACGGGATT
TGGAGTCCCATTGCCTCGT: GGAGTCCCATTGCCTCGTC
GATATCTTGCAGCTTCTTC: ATATCTTGCAGCTTCTTCA
CTACTATATTATACGTACT: TACTATATTATACGTACTG
ACTTGGCGTTGCCAAGTGG: CTTGGCGTTGCCAAGTGGA
AGGTACACCCCCTATTGCA: GGTACACCCCCTATTGCAC
CTGCCCGTTACGGACCCCA: TGCCCGTTACGGACCCCAA
CAACAGTCGGGCATAGTCC: AACAGTCGGGCATAGTCCG
GGCAAGGGCTGCCGTGAAT: GCAAGGGCTGCCGTGAATA
CCTAGGCTGCGTTGGAGCT: CTAGGCTGCGTTGGAGCTC
GAAATTGGAGGCGGCGGGA: AAATTGGAGGCGGCGGGAC
ATCTTGATAAGGCGAGCAG: TCTTGATAAGGCGAGCAGG
ACCATTCAACATGTATTGG: CCATTCAACATGTATTGGC
CAAAGCATCTTACTTTACC: AAAGCATCTTACTTTACCA
TAACTGGTTCCTTTATAGA: AACTGGTTCCTTTATAGAT
GGTGCCAGTCGCGGTAACA: GTGCCAGTCGCGGTAACAT
TTCCGCTTCAAGAGTTGTA: TCCGCTTCAAGAGTTGTAG
ATCAGCCCTTTTTCTCGTA: TCAGCCCTTTTTCTCGTAA
TATAGATTTGTAGAATTCA: ATAGATTTGTAGAATTCAT
TTCTTAACGCGTAGCAGGT: TCTTAACGCGTAGCAGGTC
CATATCCAAGTCTTAGACG: ATATCCAAGTCTTAGACGT
TATGATTAGCCAGCTTCAC: ATGATTAGCCAGCTTCACG
CATGTATTGGCGTCGCCCA: ATGTATTGGCGTCGCCCAC
GCTAGTGAGAGGCTACCAT: CTAGTGAGAGGCTACCATT
AGAAATACCTGCGCAGTAC: GAAATACCTGCGCAGTACG
GGGCTTTAAAAAAAAACAG: GGCTTTAAAAAAAAACAGG
GCCCCCCCTAGGCTGCGTT: CCCCCCCTAGGCTGCGTTG
TGCCTGGCCGGCGGTTGCG: GCCTGGCCGGCGGTTGCGG
GACGTGACGACGGTGCCAT: ACGTGACGACGGTGCCATA
ATCGAAGGTACTCGCAATG: TCGAAGGTACTCGCAATGC
CGCACTTAGGTAGAGGTAT: GCACTTAGGTAGAGGTATG
GGATGTCTGGTCCAAAGTA: GATGTCTGGTCCAAAGTAT
ACAATCTGTTGCACGTATA: CAATCTGTTGCACGTATAA
CTTCTTCACGCTTGTATCT: TTCTTCACGCTTGTATCTT
AGTCACAATCTGTTGCACG: GTCACAATCTGTTGCACGT
TGTATCTTTGGCGCATCTG: GTATCTTTGGCGCATCTGC
GGGAGGCTTTTAACCCACT: GGAGGCTTTTAACCCACTG
ACAGTCGGGCATAGTCCGG: CAGTCGGGCATAGTCCGGG
TCGCCCACGGAGCTATCCT: CGCCCACGGAGCTATCCTG
ATTCTTAACGCGTAGCAGG: TTCTTAACGCGTAGCAGGT
CTCACGCGGTCGCGGTTAT: TCACGCGGTCGCGGTTATA
AGCATCTTACTTTACCATC: GCATCTTACTTTACCATCT
CTGCCAGAACTATTGGTCC: TGCCAGAACTATTGGTCCA
TGGCCACCGAGGCTGCCCT: GGCCACCGAGGCTGCCCTC
TAGGCGAGGCTAGCGGTCG: AGGCGAGGCTAGCGGTCGT
TTCTTCCGCTTCAAGAGTT: TCTTCCGCTTCAAGAGTTG
TTAGGTAGAGGTATGAACT: TAGGTAGAGGTATGAACTG
CTCGAACTCGTTGCACGGC: TCGAACTCGTTGCACGGCA
AAGGAATATGGCATCCTCA: AGGAATATGGCATCCTCAA
GTAAGAGCCCGGGACAGCT: TAAGAGCCCGGGACAGCTG
GAGTCCCATTGCCTCGTCA: AGTCCCATTGCCTCGTCAA
CTATTCACGCTTGTATCTT: TATTCACGCTTGTATCTTT
GTCCGTGCGCGGGAAAAGA: TCCGTGCGCGGGAAAAGAC
GGTGCCTACTGCTGTCGAG: GTGCCTACTGCTGTCGAGG
TGGGGTGCCACCTAGTACC: GGGGTGCCACCTAGTACCT
TTCGCAGTATCCGGCGCCG: TCGCAGTATCCGGCGCCGA
TTACGAGTCGAGAAATACC: TACGAGTCGAGAAATACCT
GTAGCAGGTCAGACGGTGC: TAGCAGGTCAGACGGTGCG
GGAGCGAGTCACAATCTGT: GAGCGAGTCACAATCTGTT
GCGATTGTACTTAGGCAAT: CGATTGTACTTAGGCAATC
TTAGACGTTTGTAAGCCTG: TAGACGTTTGTAAGCCTGT
ATCTTGAACCTACTTGGCG: TCTTGAACCTACTTGGCGT
TGGAGACACAGCAGCAGTA: GGAGACACAGCAGCAGTAC
CGGAGCTATCCTGATATAC: GGAGCTATCCTGATATACA
TTGGTCCGTGCGCGGGAAA: TGGTCCGTGCGCGGGAAAA
TGAGCGAGCGCGTAATGCG: GAGCGAGCGCGTAATGCGG
TGGCGCATCTGCATCTTGA: GGCGCATCTGCATCTTGAA
ATCTTTGGCCCCCCCTAGG: TCTTTGGCCCCCCCTAGGC
TGGCCGGCGGTTGCGGGAG: GGCCGGCGGTTGCGGGAGC
CTGATATACAAGGCAAAAA: TGATATACAAGGCAAAAAG
TCATAAGCTCGTAAGTAAC: CATAAGCTCGTAAGTAACC
GAGGATCAAGTGGACTTTT: AGGATCAAGTGGACTTTTA
TCAACAGTCGGGCATAGTC: CAACAGTCGGGCATAGTCC
CCCTATTGCACAGGGAGCG: CCTATTGCACAGGGAGCGA
TGATTATGGTGAGTGGCAG: GATTATGGTGAGTGGCAGT
TGCCGGCATATCCAAGTCT: GCCGGCATATCCAAGTCTT
TCGTAAGTAACCCCGTATG: CGTAAGTAACCCCGTATGT
ATCGTGCCGGCATATCCAA: TCGTGCCGGCATATCCAAG
TCGCGTGAATACACTCTTC: CGCGTGAATACACTCTTCT
CCTCGTTAGAAAGGTTTTG: CTCGTTAGAAAGGTTTTGA
CGGGAGCGACGAACACACA: GGGAGCGACGAACACACAA
GTACTTTATGGATATGATT: TACTTTATGGATATGATTA
CCCATACAACGCCTCGTAG: CCATACAACGCCTCGTAGG
AAGTGGAGTTGAGTGACGC: AGTGGAGTTGAGTGACGCC
GATATTTGGAACTATTAAC: ATATTTGGAACTATTAACT
TTGTAGAATTCATCGAGAA: TGTAGAATTCATCGAGAAC
AGTCCCATTGCCTCGTCAA: GTCCCATTGCCTCGTCAAC
GCCCTCTGCCATAGTCAAG: CCCTCTGCCATAGTCAAGG
TAGTGGCCCTCCCCCGAAG: AGTGGCCCTCCCCCGAAGG
GACAGCTGCCGCCTTCGGT: ACAGCTGCCGCCTTCGGTT
TCCGCTTCAAGAGTTGTAG: CCGCTTCAAGAGTTGTAGT
CATGCAGTACTTTATGGAT: ATGCAGTACTTTATGGATA
AGCGCAGTACTTTATGGAT: GCGCAGTACTTTATGGATA
TCTCCCGATCGAAGGTACT: CTCCCGATCGAAGGTACTC
TTTGGGTACTCATGAACTC: TTGGGTACTCATGAACTCG
GGGGTTCTTCGAGGTATGG: GGGTTCTTCGAGGTATGGA
AAGCGACGTGACGACGGTG: AGCGACGTGACGACGGTGC
AGAACTTTAGGGAAGCGCA: GAACTTTAGGGAAGCGCAG
ACTTTACCATCTGCATAAG: CTTTACCATCTGCATAAGA
AACTTTGGCACCAAGATAC: ACTTTGGCACCAAGATACA
GAACCTACTTGGCGTTGCC: AACCTACTTGGCGTTGCCA
TGTGACTCTGCTTGAGCTG: GTGACTCTGCTTGAGCTGC
GCAACATGTGTCTAATTGT: CAACATGTGTCTAATTGTC
AGGGCTGCCGTGAATACGC: GGGCTGCCGTGAATACGCC
TTTAACCCACTGATTCGGG: TTAACCCACTGATTCGGGT
ATAAAAGCAGCCCGGTGCT: TAAAAGCAGCCCGGTGCTG
GCACTTAGGTAGAGGTATG: CACTTAGGTAGAGGTATGA
CCTCCCATACAACGCCTCG: CTCCCATACAACGCCTCGT
AAGTAAACTCGATAGGTAA: AGTAAACTCGATAGGTAAA
CCGAAGGGGCACTGCTGAT: CGAAGGGGCACTGCTGATT
AGGTGCCTACTGCTGTCGA: GGTGCCTACTGCTGTCGAG
TGGTAACACAGATCGATGT: GGTAACACAGATCGATGTC
ACAGGCAGTACTTTATGGA: CAGGCAGTACTTTATGGAT
CCGATCGAAGGTACTCGCA: CGATCGAAGGTACTCGCAA
TTTACCCTCGTTAGAAAGG: TTACCCTCGTTAGAAAGGT
CTCGGGGTTCTTCGAGGTA: TCGGGGTTCTTCGAGGTAT
ACTTTATGGATATAGGCCA: CTTTATGGATATAGGCCAG
TATTGTGGCCACCGAGGCT: ATTGTGGCCACCGAGGCTG
CAAGATACAAATTCTTAAC: AAGATACAAATTCTTAACG
GGGAAATTGGAGGCGGCGG: GGAAATTGGAGGCGGCGGG
ACAGCTGCCGCCTTCGGTT: CAGCTGCCGCCTTCGGTTA
CGTGCGCGGGAAAAGACTA: GTGCGCGGGAAAAGACTAC
GTACTTTATGGATATAGGC: TACTTTATGGATATAGGCC
AGGCCAGTCTATTCACGCT: GGCCAGTCTATTCACGCTT
TCGTAGGTACTCATCTTGA: CGTAGGTACTCATCTTGAT
GCGGTAACATCAGCCCTTT: CGGTAACATCAGCCCTTTT
TCGTTAGAAAGGTTTTGAG: CGTTAGAAAGGTTTTGAGA
CTCGTTAGAAAGGTTTTGA: TCGTTAGAAAGGTTTTGAG
ATCGAGAACGCGACTAAAT: TCGAGAACGCGACTAAATT
TTGCGGGAGCGACGAACAC: TGCGGGAGCGACGAACACA
GTTTTGAGATCATTCTTAG: TTTTGAGATCATTCTTAGA
AGATTTGTAGAATTCATCG: GATTTGTAGAATTCATCGA
ACTATTAACTGGTTCCTTT: CTATTAACTGGTTCCTTTA
CCATTTCCTTGGGGTGCCA: CATTTCCTTGGGGTGCCAC
CAGTACTTTATGGATATTA: AGTACTTTATGGATATTAC
CCCCCTAGGCTGCGTTGGA: CCCCTAGGCTGCGTTGGAG
TCCAAGTCTTAGACGTTTG: CCAAGTCTTAGACGTTTGT
AGAACTATTGGTCCATGTA: GAACTATTGGTCCATGTAC
TCCTCAATGCCTGCAACCA: CCTCAATGCCTGCAACCAA
GTGAATACACTCTTCTTTA: TGAATACACTCTTCTTTAC
CGTCAACGGCAACCCAGCG: GTCAACGGCAACCCAGCGT
TCTTGCAGCTTCTTCACGC: CTTGCAGCTTCTTCACGCT
CCTACTGCTGTCGAGGTAC: CTACTGCTGTCGAGGTACA
GCTCGAATGTCACTTAAAA: CTCGAATGTCACTTAAAAT
CGGGGTTCTTCGAGGTATG: GGGGTTCTTCGAGGTATGG
TTTCTCCCGATCGAAGGTA: TTCTCCCGATCGAAGGTAC
CACCGAGGCTGCCCTCTGC: ACCGAGGCTGCCCTCTGCC
AAAGGTGTATTCAACTATA: AAGGTGTATTCAACTATAA
AGAATTCATCGAGAACGCG: GAATTCATCGAGAACGCGA
CCTCGAGCTGAAGAACTTT: CTCGAGCTGAAGAACTTTA
GCCCGTTACGGACCCCAAT: CCCGTTACGGACCCCAATC
CGCGTCGCCAACGAAATAC: GCGTCGCCAACGAAATACA
CTGAGGGGTATCGTGCCGG: TGAGGGGTATCGTGCCGGC
CCAGTATTCTCCATTTCCT: CAGTATTCTCCATTTCCTT
ACATGTATTGGCGTCGCCC: CATGTATTGGCGTCGCCCA
TTGCCTCGCGTGAATACAC: TGCCTCGCGTGAATACACT
TCTGTTGCACGTATAACAT: CTGTTGCACGTATAACATG
CGAGTCGAGAAATACCTGC: GAGTCGAGAAATACCTGCG
GCAGTTCTGACACAGGAAG: CAGTTCTGACACAGGAAGT
AGGCAAGGGCTGCCGTGAA: GGCAAGGGCTGCCGTGAAT
TTGGAGCTCGAATGTCACT: TGGAGCTCGAATGTCACTT
CATCGAGAACGCGACTAAA: ATCGAGAACGCGACTAAAT
CAGTATTCTCCATTTCCTT: AGTATTCTCCATTTCCTTG
TTAAAGGTGTATTCAACTA: TAAAGGTGTATTCAACTAT
GCAGAGATTAAAGCGACGT: CAGAGATTAAAGCGACGTG
GGCTAGCGGTCGTGATGCT: GCTAGCGGTCGTGATGCTA
ACTATAATAATCCGTCTGA: CTATAATAATCCGTCTGAA
TAAAATGTTCAGGAGCTCA: AAAATGTTCAGGAGCTCAT
TATCTTGCAGCTTCTTCAC: ATCTTGCAGCTTCTTCACG
TGTGTCTAATTGTCGGGAC: GTGTCTAATTGTCGGGACT
AGCCTGTCTGATAGAGAGG: GCCTGTCTGATAGAGAGGA
ATTGCGTTTAGTGACGGGG: TTGCGTTTAGTGACGGGGG
CGGTTATATTGTGGCCACC: GGTTATATTGTGGCCACCG
TCTATTCACGCTTGTATCT: CTATTCACGCTTGTATCTT
GTGCCACCTAGTACCTTGC: TGCCACCTAGTACCTTGCA
CTTTACCCTCGTTAGAAAG: TTTACCCTCGTTAGAAAGG
ATTCTCCATTTCCTTGGGG: TTCTCCATTTCCTTGGGGT
ACTCTGCTTGAGCTGCCCG: CTCTGCTTGAGCTGCCCGT
ATCTCGGCCGCTCGTAAAC: TCTCGGCCGCTCGTAAACC
AATTGCGTTTAGTGACGGG: ATTGCGTTTAGTGACGGGG
CGCAATGCCTCGGGGTTCT: GCAATGCCTCGGGGTTCTT
CGTTAGAAAGGTTTTGAGA: GTTAGAAAGGTTTTGAGAT
CGCTGTTCAATTGGGCTGG: GCTGTTCAATTGGGCTGGG
AATATGGCATCCTCAATGC: ATATGGCATCCTCAATGCC
AACTCGAACTCGTTGCACG: ACTCGAACTCGTTGCACGG
ACCAAGATACAAATTCTTA: CCAAGATACAAATTCTTAA
ATTGGTCCATGTACTTTTC: TTGGTCCATGTACTTTTCT
GAGCCCGGGACAGCTGCCG: AGCCCGGGACAGCTGCCGC
TAGTTGCACCGCCTCGCGA: AGTTGCACCGCCTCGCGAT
TCAATGCCTGCAACCAAGG: CAATGCCTGCAACCAAGGG
CTATTGGTCCATGTACTTT: TATTGGTCCATGTACTTTT
AACATCAGCCCTTTTTCTC: ACATCAGCCCTTTTTCTCG
GGGGATCCTGGTAACACAG: GGGATCCTGGTAACACAGA
GCCGCCTTCGGTTAAAGGT: CCGCCTTCGGTTAAAGGTG
TGAATACCAGTATTCTCCA: GAATACCAGTATTCTCCAT
CGAATGTCACTTAAAATGT: GAATGTCACTTAAAATGTT
ATGGATATTACGGGATTGG: TGGATATTACGGGATTGGT
CGTGACGACGGTGCCATAT: GTGACGACGGTGCCATATT
GCACACAGCTAGTGAGAGG: CACACAGCTAGTGAGAGGC
CAACATGTGTCTAATTGTC: AACATGTGTCTAATTGTCG
GCTGCGTTGGAGCTCGAAT: CTGCGTTGGAGCTCGAATG
CTTGAGCTGCCCGTTACGG: TTGAGCTGCCCGTTACGGA
AGCCCTTTTTCTCGTAAGA: GCCCTTTTTCTCGTAAGAG
ACCCTCGAGCTGAAGAACT: CCCTCGAGCTGAAGAACTT
CACAAACTAACGTTTAGTC: ACAAACTAACGTTTAGTCG
TTGAATACCAGTATTCTCC: TGAATACCAGTATTCTCCA
CAGGGAGCGAGTCACAATC: AGGGAGCGAGTCACAATCT
TCTGCATAAGACGCAGCTT: CTGCATAAGACGCAGCTTT
GTTGAGTGACGCCTCCCAT: TTGAGTGACGCCTCCCATA
TTACGGGATTGGTTCACGC: TACGGGATTGGTTCACGCT
CAATTGGGCTGGGGATCCT: AATTGGGCTGGGGATCCTG
ATAGATTTGTAGAATTCAT: TAGATTTGTAGAATTCATC
CCCGTTACGGACCCCAATC: CCGTTACGGACCCCAATCG
GAGATCATTCTTAGATATT: AGATCATTCTTAGATATTT
GTATCTTTGGCCCCCCCTA: TATCTTTGGCCCCCCCTAG
TGCAGCTTCTTCACGCTTG: GCAGCTTCTTCACGCTTGT
GGCCACCGAGGCTGCCCTC: GCCACCGAGGCTGCCCTCT
AACTATTAACTGGTTCCTT: ACTATTAACTGGTTCCTTT
CGACTAAATTGCGTTTAGT: GACTAAATTGCGTTTAGTG
AGTGAGAGGCTACCATTCA: GTGAGAGGCTACCATTCAA
TGGTCCATGTACTTTTCTG: GGTCCATGTACTTTTCTGA
CCTCGTCAACGGCAACCCA: CTCGTCAACGGCAACCCAG
TGCTGAGGGGTATCGTGCC: GCTGAGGGGTATCGTGCCG
TGTGCCTGGCCGGCGGTTG: GTGCCTGGCCGGCGGTTGC
AAATTGCGTTTAGTGACGG: AATTGCGTTTAGTGACGGG
CGACGAACACACAAGAGCC: GACGAACACACAAGAGCCA
CAAGTCTTAGACGTTTGTA: AAGTCTTAGACGTTTGTAA
TGCCTGCAACCAAGGGAAC: GCCTGCAACCAAGGGAACA
CTTTATGGATATAGGCCAG: TTTATGGATATAGGCCAGT
TCGAATGTCACTTAAAATG: CGAATGTCACTTAAAATGT
TACTGTGACTCTGCTTGAG: ACTGTGACTCTGCTTGAGC
AGCGGTCGTGATGCTATAA: GCGGTCGTGATGCTATAAA
CTAGCGGTCGTGATGCTAT: TAGCGGTCGTGATGCTATA
GCGTTGGAGCTCGAATGTC: CGTTGGAGCTCGAATGTCA
CTTCTTTACCCTCGTTAGA: TTCTTTACCCTCGTTAGAA
AGGGAGCGAGTCACAATCT: GGGAGCGAGTCACAATCTG
GAAGAACTTTAGGGAAGCG: AAGAACTTTAGGGAAGCGC
CGCCTCCCATACAACGCCT: GCCTCCCATACAACGCCTC
ACCATTCTCAGGCAAGGGC: CCATTCTCAGGCAAGGGCT
TCTTTGGGCACGGTAAGTT: CTTTGGGCACGGTAAGTTG
GACGGTGCCATATTTCTCA: ACGGTGCCATATTTCTCAC
ATTGGCGTCGCCCACGGAG: TTGGCGTCGCCCACGGAGC
CCAATCTATAGTGGACGCA: CAATCTATAGTGGACGCAA
GAGGTACACCCCCTATTGC: AGGTACACCCCCTATTGCA
CCGGTAATACTGTAGGGAT: CGGTAATACTGTAGGGATG
CAGTCGGGCATAGTCCGGG: AGTCGGGCATAGTCCGGGC
TTCGGGTTTTCTTTGGGTA: TCGGGTTTTCTTTGGGTAC
CAGCAGTACTTTATGGATA: AGCAGTACTTTATGGATAT
GCTTAGTCCTTCTTCCGCT: CTTAGTCCTTCTTCCGCTT
ATGAACTCGAACTCGTTGC: TGAACTCGAACTCGTTGCA
GCTCATGCAGTACTTTATG: CTCATGCAGTACTTTATGG
CCCTCTGCCATAGTCAAGG: CCTCTGCCATAGTCAAGGA
TGACTCTGCTTGAGCTGCC: GACTCTGCTTGAGCTGCCC
CCCCAATCGTAGTGGCCCT: CCCAATCGTAGTGGCCCTC
CAGTACTTTATGGATATCT: AGTACTTTATGGATATCTT
GCGAGGCTAGCGGTCGTGA: CGAGGCTAGCGGTCGTGAT
CAACCAAGGGAACATACAG: AACCAAGGGAACATACAGG
CAAAGCGGGTGCCAGTCGC: AAAGCGGGTGCCAGTCGCG
ATCGCAGGGACTCAACAGT: TCGCAGGGACTCAACAGTC
ACTTTATGGATATCTTGCA: CTTTATGGATATCTTGCAG
ATACAACGCCTCGTAGGTA: TACAACGCCTCGTAGGTAC
GCAAAAAGGCGGTGTCAGC: CAAAAAGGCGGTGTCAGCT
AATCTATAGTGGACGCAAG: ATCTATAGTGGACGCAAGC
ACTCTTCTTTACCCTCGTT: CTCTTCTTTACCCTCGTTA
AGGTGTATTCAACTATAAT: GGTGTATTCAACTATAATA
GGTCAGACGGTGCGAGCAA: GTCAGACGGTGCGAGCAAC
TAGCGGTCGTGATGCTATA: AGCGGTCGTGATGCTATAA
GAGGCTGCCCTCTGCCATA: AGGCTGCCCTCTGCCATAG
TTGCCTCGTCAACGGCAAC: TGCCTCGTCAACGGCAACC
ATTGGTCCGTGCGCGGGAA: TTGGTCCGTGCGCGGGAAA
GGAACATACAGGCAGTACT: GAACATACAGGCAGTACTT
AGGTACTCATCTTGATAAG: GGTACTCATCTTGATAAGG
TATACAAGGCAAAAAGGCG: ATACAAGGCAAAAAGGCGG
CACGCTTGTATCTTTGGCC: ACGCTTGTATCTTTGGCCC
GGTTGGAGACACAGCAGCA: GTTGGAGACACAGCAGCAG
ATTCATCGAGAACGCGACT: TTCATCGAGAACGCGACTA
AAGGGGCACTGCTGATTAT: AGGGGCACTGCTGATTATG
TATGGATATTACGGGATTG: ATGGATATTACGGGATTGG
TAGGGAAGCGCAGAGGATC: AGGGAAGCGCAGAGGATCA
CTCGTAAACCAGTGGCAGA: TCGTAAACCAGTGGCAGAA
TCTGCATCTTGAACCTACT: CTGCATCTTGAACCTACTT
CGCAGTACGTTGTAGGCGA: GCAGTACGTTGTAGGCGAG
AATACACGACGCTGTTCAA: ATACACGACGCTGTTCAAT
GATCACAAACTAACGTTTA: ATCACAAACTAACGTTTAG
CCTGCGCAGTACGTTGTAG: CTGCGCAGTACGTTGTAGG
TATACATGATCTGGCGCCA: ATACATGATCTGGCGCCAT
ATCTGGCGCCATGCTGCCA: TCTGGCGCCATGCTGCCAG
ACGGTGCCATATTTCTCAC: CGGTGCCATATTTCTCACG
GCTGCCAGAACTATTGGTC: CTGCCAGAACTATTGGTCC
GCCACCGAGGCTGCCCTCT: CCACCGAGGCTGCCCTCTG
CTCTTCTTTACCCTCGTTA: TCTTCTTTACCCTCGTTAG
CAAGCTTACGAGTCGAGAA: AAGCTTACGAGTCGAGAAA
ACCAAGGGAACATACAGGC: CCAAGGGAACATACAGGCA
ACTCAACAGTCGGGCATAG: CTCAACAGTCGGGCATAGT
GGGGCACTGCTGATTATGG: GGGCACTGCTGATTATGGT
TCTGAGCGAGCGCGTAATG: CTGAGCGAGCGCGTAATGC
CCCTCGAGCTGAAGAACTT: CCTCGAGCTGAAGAACTTT
GCCAGCTTCACGCTTGTAT: CCAGCTTCACGCTTGTATC
CACTTAGGTAGAGGTATGA: ACTTAGGTAGAGGTATGAA
TAGTACCTTGCATTGCCTC: AGTACCTTGCATTGCCTCG
AGTTGTAGTTGCACCGCCT: GTTGTAGTTGCACCGCCTC
ATTCAACTATAATAATCCG: TTCAACTATAATAATCCGT
GTTGCGGGAGCGACGAACA: TTGCGGGAGCGACGAACAC
GGGCACTGCTGATTATGGT: GGCACTGCTGATTATGGTG
TGCCATAGTCAAGGAATAT: GCCATAGTCAAGGAATATG
GCATAGTCCGGGCTTTAAA: CATAGTCCGGGCTTTAAAA
GGAGCGACGAACACACAAG: GAGCGACGAACACACAAGA
ACCGGTAATACTGTAGGGA: CCGGTAATACTGTAGGGAT
AAGATACAAATTCTTAACG: AGATACAAATTCTTAACGC
AGCAACATGTGTCTAATTG: GCAACATGTGTCTAATTGT
CCTCAATGCCTGCAACCAA: CTCAATGCCTGCAACCAAG
CAGTCTATTCACGCTTGTA: AGTCTATTCACGCTTGTAT
TCTGGCGCCATGCTGCCAG: CTGGCGCCATGCTGCCAGA
CAATCTATAGTGGACGCAA: AATCTATAGTGGACGCAAG
CGATAGGTAAACCCAGCTA: GATAGGTAAACCCAGCTAT
AACTATTGGTCCATGTACT: ACTATTGGTCCATGTACTT
GTAGTGGCCCTCCCCCGAA: TAGTGGCCCTCCCCCGAAG
CTTGCATTGCCTCGCGTGA: TTGCATTGCCTCGCGTGAA
ACGCCCGCGTTCGCAGTAT: CGCCCGCGTTCGCAGTATC
TTTGGCACCAAGATACAAA: TTGGCACCAAGATACAAAT
ACATGCCTCGGGAAATTGG: CATGCCTCGGGAAATTGGA
CTCACAAAGCATCTTACTT: TCACAAAGCATCTTACTTT
TAGTCGCGTCGCCAACGAA: AGTCGCGTCGCCAACGAAA
ACGAAATACACGACGCTGT: CGAAATACACGACGCTGTT
CTTTGGCGCATCTGCATCT: TTTGGCGCATCTGCATCTT
TGGTTCACGCTTGTATCTT: GGTTCACGCTTGTATCTTT
ACACAGGAAGTAAACTCGA: CACAGGAAGTAAACTCGAT
GGCGCCGACACCAATTGGT: GCGCCGACACCAATTGGTC
GGTAAGTTGTATAACCGAT: GTAAGTTGTATAACCGATC
GCCTCCCATACAACGCCTC: CCTCCCATACAACGCCTCG
CATTCTTAGATATTTGGAA: ATTCTTAGATATTTGGAAC
TAATCCGTCTGAAACCATT: AATCCGTCTGAAACCATTC
AAGGCGAGCAGGAGACGTG: AGGCGAGCAGGAGACGTGC
CTGCCATAGTCAAGGAATA: TGCCATAGTCAAGGAATAT
ACGGTAAGTTGTATAACCG: CGGTAAGTTGTATAACCGA
GGAACTATTAACTGGTTCC: GAACTATTAACTGGTTCCT
CGGCGGGACCCTCGAGCTG: GGCGGGACCCTCGAGCTGA
AGCGACGAACACACAAGAG: GCGACGAACACACAAGAGC
AAATGTTCAGGAGCTCATG: AATGTTCAGGAGCTCATGC
CTGCATAAGACGCAGCTTT: TGCATAAGACGCAGCTTTC
CTTCCGCTTCAAGAGTTGT: TTCCGCTTCAAGAGTTGTA
ACGTACTGTGACTCTGCTT: CGTACTGTGACTCTGCTTG
ATTATGGTGAGTGGCAGTT: TTATGGTGAGTGGCAGTTC
GGACTCAACAGTCGGGCAT: GACTCAACAGTCGGGCATA
TAGTGAGAGGCTACCATTC: AGTGAGAGGCTACCATTCA
ACCCAGCGTAAACTTTGGC: CCCAGCGTAAACTTTGGCA
AACTATAATAATCCGTCTG: ACTATAATAATCCGTCTGA
GGATATGATTAGCCAGCTT: GATATGATTAGCCAGCTTC
AAAAAACAGGTGCCTACTG: AAAAACAGGTGCCTACTGC
TTTATGGATATAGGCCAGT: TTATGGATATAGGCCAGTC
TAACGCGTAGCAGGTCAGA: AACGCGTAGCAGGTCAGAC
AGCTCGTAAGTAACCCCGT: GCTCGTAAGTAACCCCGTA
CTCATGCAGTACTTTATGG: TCATGCAGTACTTTATGGA
AAACCATTCTCAGGCAAGG: AACCATTCTCAGGCAAGGG
CTGAGCGAGCGCGTAATGC: TGAGCGAGCGCGTAATGCG
ACCGAGGCTGCCCTCTGCC: CCGAGGCTGCCCTCTGCCA
TGAATACACTCTTCTTTAC: GAATACACTCTTCTTTACC
GCGAGCGCGTAATGCGGTC: CGAGCGCGTAATGCGGTCC
AAGGGAACATACAGGCAGT: AGGGAACATACAGGCAGTA
CGGTAAGTTGTATAACCGA: GGTAAGTTGTATAACCGAT
GGCTGCCCTCTGCCATAGT: GCTGCCCTCTGCCATAGTC
CCCACGGAGCTATCCTGAT: CCACGGAGCTATCCTGATA
ATGATTAGCCAGCTTCACG: TGATTAGCCAGCTTCACGC
GTATTGGCGTCGCCCACGG: TATTGGCGTCGCCCACGGA
CCGGCGCCGACACCAATTG: CGGCGCCGACACCAATTGG
CAATCGCAGGGACTCAACA: AATCGCAGGGACTCAACAG
AACTCGATAGGTAAACCCA: ACTCGATAGGTAAACCCAG
AAATTGGAGGCGGCGGGAC: AATTGGAGGCGGCGGGACC
GACGTGCGCACTTAGGTAG: ACGTGCGCACTTAGGTAGA
GAGCCAATCTATAGTGGAC: AGCCAATCTATAGTGGACG
TCTTGGGTTGGAGACACAG: CTTGGGTTGGAGACACAGC
AACCCAGCTATTGAATACC: ACCCAGCTATTGAATACCA
GATCATAAGCTCGTAAGTA: ATCATAAGCTCGTAAGTAA
CCAACGAAATACACGACGC: CAACGAAATACACGACGCT
TACTATATTATACGTACTG: ACTATATTATACGTACTGT
ACAAGGCAAAAAGGCGGTG: CAAGGCAAAAAGGCGGTGT
ACCGCAAAGCGGGTGCCAG: CCGCAAAGCGGGTGCCAGT
GGTGCTGCTGAGGGGTATC: GTGCTGCTGAGGGGTATCG
TATAAAAGCAGCCCGGTGC: ATAAAAGCAGCCCGGTGCT
ATGGATATGATTAGCCAGC: TGGATATGATTAGCCAGCT
CATCCTCAATGCCTGCAAC: ATCCTCAATGCCTGCAACC
CTATCCTGATATACAAGGC: TATCCTGATATACAAGGCA
GGCGTTGCCAAGTGGAGTT: GCGTTGCCAAGTGGAGTTG
CTATATTATACGTACTGTG: TATATTATACGTACTGTGA
CTGCCCTCTGCCATAGTCA: TGCCCTCTGCCATAGTCAA
AGGGAACATACAGGCAGTA: GGGAACATACAGGCAGTAC
ACGCGACTAAATTGCGTTT: CGCGACTAAATTGCGTTTA
TGGGGATCCTGGTAACACA: GGGGATCCTGGTAACACAG
TTGGCGCATCTGCATCTTG: TGGCGCATCTGCATCTTGA
CCAATCGTAGTGGCCCTCC: CAATCGTAGTGGCCCTCCC
ATACACTCTTCTTTACCCT: TACACTCTTCTTTACCCTC
TGCCATATTTCTCACGCGG: GCCATATTTCTCACGCGGT
CATGATCTGGCGCCATGCT: ATGATCTGGCGCCATGCTG
ACCAATTGGTCCGTGCGCG: CCAATTGGTCCGTGCGCGG
CGTATAACATGCCTCGGGA: GTATAACATGCCTCGGGAA
GCTGTTCAATTGGGCTGGG: CTGTTCAATTGGGCTGGGG
CTTTGGCTTGATCTCACAA: TTTGGCTTGATCTCACAAA
GCTGAGGGGTATCGTGCCG: CTGAGGGGTATCGTGCCGG
ACGGCAACCCAGCGTAAAC: CGGCAACCCAGCGTAAACT
CTCTGCCATAGTCAAGGAA: TCTGCCATAGTCAAGGAAT
GTTCCTTTATAGATTTGTA: TTCCTTTATAGATTTGTAG
CAGCGTAAACTTTGGCACC: AGCGTAAACTTTGGCACCA
TGGTCCGTGCGCGGGAAAA: GGTCCGTGCGCGGGAAAAG
CGCTTCAAGAGTTGTAGTT: GCTTCAAGAGTTGTAGTTG
ACGAGCGCAGTACTTTATG: CGAGCGCAGTACTTTATGG
GGACAGCTGCCGCCTTCGG: GACAGCTGCCGCCTTCGGT
TCGCAGGGACTCAACAGTC: CGCAGGGACTCAACAGTCG
ATGCCTCGGGAAATTGGAG: TGCCTCGGGAAATTGGAGG
CTTTCTCCCGATCGAAGGT: TTTCTCCCGATCGAAGGTA
AGTTGAGTGACGCCTCCCA: GTTGAGTGACGCCTCCCAT
TATCTTTGGCGCATCTGCA: ATCTTTGGCGCATCTGCAT
CCAGTCTATTCACGCTTGT: CAGTCTATTCACGCTTGTA
GAGCTGAAGAACTTTAGGG: AGCTGAAGAACTTTAGGGA
TTACTTTACCATCTGCATA: TACTTTACCATCTGCATAA
CCGAGGCTGCCCTCTGCCA: CGAGGCTGCCCTCTGCCAT
CAGCTTCTTCACGCTTGTA: AGCTTCTTCACGCTTGTAT
GAGCGCAGTACTTTATGGA: AGCGCAGTACTTTATGGAT
ATCTTTGGGCACGGTAAGT: TCTTTGGGCACGGTAAGTT
AGCTCATGCAGTACTTTAT: GCTCATGCAGTACTTTATG
AAGGCGGTGTCAGCTTAGT: AGGCGGTGTCAGCTTAGTC
CGGTGCTGCTGAGGGGTAT: GGTGCTGCTGAGGGGTATC
GTCTAATTGTCGGGACTAC: TCTAATTGTCGGGACTACT
GGACCCTCGAGCTGAAGAA: GACCCTCGAGCTGAAGAAC
GTCGGGACTACTATATTAT: TCGGGACTACTATATTATA
ATCTGCATAAGACGCAGCT: TCTGCATAAGACGCAGCTT
CCTGGTAACACAGATCGAT: CTGGTAACACAGATCGATG
CATAAGCTCGTAAGTAACC: ATAAGCTCGTAAGTAACCC
TATCTTTGGCCCCCCCTAG: ATCTTTGGCCCCCCCTAGG
GTTGCACGGCAGAGATTAA: TTGCACGGCAGAGATTAAA
TCCGGGCTTTAAAAAAAAA: CCGGGCTTTAAAAAAAAAC
TTGGCTTGATCTCACAAAG: TGGCTTGATCTCACAAAGC
GCATCTTGAACCTACTTGG: CATCTTGAACCTACTTGGC
AGGCTGCCCTCTGCCATAG: GGCTGCCCTCTGCCATAGT
CACAGGGAGCGAGTCACAA: ACAGGGAGCGAGTCACAAT
TGCCGTGAATACGCCCGCG: GCCGTGAATACGCCCGCGT
GGATTGGTTCACGCTTGTA: GATTGGTTCACGCTTGTAT
GTCTGAAACCATTCTCAGG: TCTGAAACCATTCTCAGGC
TTCCTTTATAGATTTGTAG: TCCTTTATAGATTTGTAGA
CTCGCGATTGTACTTAGGC: TCGCGATTGTACTTAGGCA
CCGGCGGTTGCGGGAGCGA: CGGCGGTTGCGGGAGCGAC
CAAGGGCTGCCGTGAATAC: AAGGGCTGCCGTGAATACG
GACCCCAATCGTAGTGGCC: ACCCCAATCGTAGTGGCCC
GGATATCTTGCAGCTTCTT: GATATCTTGCAGCTTCTTC
GTATCTTGGGTTGGAGACA: TATCTTGGGTTGGAGACAC
GAATGTCACTTAAAATGTT: AATGTCACTTAAAATGTTC
ATTCTTAGATATTTGGAAC: TTCTTAGATATTTGGAACT
CTAGTACCTTGCATTGCCT: TAGTACCTTGCATTGCCTC
CGTTGCCAAGTGGAGTTGA: GTTGCCAAGTGGAGTTGAG
TGCTATAAAAGCAGCCCGG: GCTATAAAAGCAGCCCGGT
CGCAGGGACTCAACAGTCG: GCAGGGACTCAACAGTCGG
AACCGATCATAAGCTCGTA: ACCGATCATAAGCTCGTAA
CTTGGGGTGCCACCTAGTA: TTGGGGTGCCACCTAGTAC
GCACCAAGATACAAATTCT: CACCAAGATACAAATTCTT
GAAAAGACTACGAGCGCAG: AAAAGACTACGAGCGCAGT
AGAGGCTACCATTCAACAT: GAGGCTACCATTCAACATG
CGCCTCGCGATTGTACTTA: GCCTCGCGATTGTACTTAG
AGACGCAGCTTTCTCCCGA: GACGCAGCTTTCTCCCGAT
GGCTTTTAACCCACTGATT: GCTTTTAACCCACTGATTC
TGTACTTTTCTGAGCGAGC: GTACTTTTCTGAGCGAGCG
GGCAATCGCAGGGACTCAA: GCAATCGCAGGGACTCAAC
AGTACCTTGCATTGCCTCG: GTACCTTGCATTGCCTCGC
CCCACTGATTCGGGTTTTC: CCACTGATTCGGGTTTTCT
AGTGGACTTTTAAGACCGC: GTGGACTTTTAAGACCGCA
ACGCGTAGCAGGTCAGACG: CGCGTAGCAGGTCAGACGG
CGTGCGCACTTAGGTAGAG: GTGCGCACTTAGGTAGAGG
TGCCCGTTACGGACCCCAA: GCCCGTTACGGACCCCAAT
CTTAGATATTTGGAACTAT: TTAGATATTTGGAACTATT
ATCCGTCTGAAACCATTCT: TCCGTCTGAAACCATTCTC
AGACGTGCGCACTTAGGTA: GACGTGCGCACTTAGGTAG
TTTCTCACGCGGTCGCGGT: TTCTCACGCGGTCGCGGTT
GTGCCTGGCCGGCGGTTGC: TGCCTGGCCGGCGGTTGCG
GCAGTACTTTATGGATATG: CAGTACTTTATGGATATGA
GGGTTCTTCGAGGTATGGA: GGTTCTTCGAGGTATGGAT
TCGCAGTATCCGGCGCCGA: CGCAGTATCCGGCGCCGAC
TCGGGGTTCTTCGAGGTAT: CGGGGTTCTTCGAGGTATG
CCATGCTGCCAGAACTATT: CATGCTGCCAGAACTATTG
GTGCTGCTGAGGGGTATCG: TGCTGCTGAGGGGTATCGT
TGCCTCGTCAACGGCAACC: GCCTCGTCAACGGCAACCC
TACGAGCGCAGTACTTTAT: ACGAGCGCAGTACTTTATG
GTGACTCTGCTTGAGCTGC: TGACTCTGCTTGAGCTGCC
CAGTACGTTGTAGGCGAGG: AGTACGTTGTAGGCGAGGC
CGGGTGCCAGTCGCGGTAA: GGGTGCCAGTCGCGGTAAC
CCGCGTTCGCAGTATCCGG: CGCGTTCGCAGTATCCGGC
GACACCAATTGGTCCGTGC: ACACCAATTGGTCCGTGCG
GACACAGCAGCAGTACTTT: ACACAGCAGCAGTACTTTA
TCTTTGGCTTGATCTCACA: CTTTGGCTTGATCTCACAA
TAATTGTCGGGACTACTAT: AATTGTCGGGACTACTATA
CTTAAAATGTTCAGGAGCT: TTAAAATGTTCAGGAGCTC
CGCTTGTATCTTTGGCCCC: GCTTGTATCTTTGGCCCCC
CTATAGTGGACGCAAGCTT: TATAGTGGACGCAAGCTTA
CTTCAAGAGTTGTAGTTGC: TTCAAGAGTTGTAGTTGCA
GTTGGAGACACAGCAGCAG: TTGGAGACACAGCAGCAGT
GTCACAATCTGTTGCACGT: TCACAATCTGTTGCACGTA
CAAGAGTTGTAGTTGCACC: AAGAGTTGTAGTTGCACCG
GATCAAGTGGACTTTTAAG: ATCAAGTGGACTTTTAAGA
GCATCTTACTTTACCATCT: CATCTTACTTTACCATCTG
GCGGTGTCAGCTTAGTCCT: CGGTGTCAGCTTAGTCCTT
ACGGACCCCAATCGTAGTG: CGGACCCCAATCGTAGTGG
ATGGATATAGGCCAGTCTA: TGGATATAGGCCAGTCTAT
CACCAATTGGTCCGTGCGC: ACCAATTGGTCCGTGCGCG
CCTCCCCCGAAGGGGCACT: CTCCCCCGAAGGGGCACTG
CAATGCCTCGGGGTTCTTC: AATGCCTCGGGGTTCTTCG
GCAGGTCAGACGGTGCGAG: CAGGTCAGACGGTGCGAGC
ACACCAATTGGTCCGTGCG: CACCAATTGGTCCGTGCGC
TCCCCCGAAGGGGCACTGC: CCCCCGAAGGGGCACTGCT
AATTGGTCCGTGCGCGGGA: ATTGGTCCGTGCGCGGGAA
TTAGCCAGCTTCACGCTTG: TAGCCAGCTTCACGCTTGT
CAGCTAGTGAGAGGCTACC: AGCTAGTGAGAGGCTACCA
TAGGCAATCGCAGGGACTC: AGGCAATCGCAGGGACTCA
TCTTTGGGTACTCATGAAC: CTTTGGGTACTCATGAACT
CGGTTGCGGGAGCGACGAA: GGTTGCGGGAGCGACGAAC
GAACTATTAACTGGTTCCT: AACTATTAACTGGTTCCTT
ACCATCTGCATAAGACGCA: CCATCTGCATAAGACGCAG
GCTCGTAAGTAACCCCGTA: CTCGTAAGTAACCCCGTAT
TGACGACGGTGCCATATTT: GACGACGGTGCCATATTTC
ATATAGGCCAGTCTATTCA: TATAGGCCAGTCTATTCAC
GACTACTATATTATACGTA: ACTACTATATTATACGTAC
CGGGCTTTAAAAAAAAACA: GGGCTTTAAAAAAAAACAG
GTGGCCCTCCCCCGAAGGG: TGGCCCTCCCCCGAAGGGG
CCATCTGCATAAGACGCAG: CATCTGCATAAGACGCAGC
ACGGTGCGAGCAACATGTG: CGGTGCGAGCAACATGTGT
GGCCGCTCGTAAACCAGTG: GCCGCTCGTAAACCAGTGG
CAAATTCTTAACGCGTAGC: AAATTCTTAACGCGTAGCA
GCAGGGACTCAACAGTCGG: CAGGGACTCAACAGTCGGG
CTTGATAAGGCGAGCAGGA: TTGATAAGGCGAGCAGGAG
GGAATATGGCATCCTCAAT: GAATATGGCATCCTCAATG
TATTGCACAGGGAGCGAGT: ATTGCACAGGGAGCGAGTC
CGTTACGGACCCCAATCGT: GTTACGGACCCCAATCGTA
TGCCAAGTGGAGTTGAGTG: GCCAAGTGGAGTTGAGTGA
AAAGCGACGTGACGACGGT: AAGCGACGTGACGACGGTG
GGAGCTCGAATGTCACTTA: GAGCTCGAATGTCACTTAA
GGCCAGTCTATTCACGCTT: GCCAGTCTATTCACGCTTG
GCAAGGGCTGCCGTGAATA: CAAGGGCTGCCGTGAATAC
CTCAACAGTCGGGCATAGT: TCAACAGTCGGGCATAGTC
TTTATAGATTTGTAGAATT: TTATAGATTTGTAGAATTC
GGGGGTATACATGATCTGG: GGGGTATACATGATCTGGC
GTATCTTTGGGCACGGTAA: TATCTTTGGGCACGGTAAG
TAAGACCGCAAAGCGGGTG: AAGACCGCAAAGCGGGTGC
AGGCGGCGGGACCCTCGAG: GGCGGCGGGACCCTCGAGC
GCGCGGGAAAAGACTACGA: CGCGGGAAAAGACTACGAG
GTTGCCAAGTGGAGTTGAG: TTGCCAAGTGGAGTTGAGT
GGTAAACCCAGCTATTGAA: GTAAACCCAGCTATTGAAT
GGCGGGACCCTCGAGCTGA: GCGGGACCCTCGAGCTGAA
CTCCCCCGAAGGGGCACTG: TCCCCCGAAGGGGCACTGC
GCCTACTGCTGTCGAGGTA: CCTACTGCTGTCGAGGTAC
ACGCTTGTATCTTTGGCCC: CGCTTGTATCTTTGGCCCC
TCGCGATTGTACTTAGGCA: CGCGATTGTACTTAGGCAA
AGTGGCAGAACCGGTAATA: GTGGCAGAACCGGTAATAC
AGTATCTTGGGTTGGAGAC: GTATCTTGGGTTGGAGACA
GAGCGAGCGCGTAATGCGG: AGCGAGCGCGTAATGCGGT
TGGATATTACGGGATTGGT: GGATATTACGGGATTGGTT
GACACAGGAAGTAAACTCG: ACACAGGAAGTAAACTCGA
GTACGTTGTAGGCGAGGCT: TACGTTGTAGGCGAGGCTA
ACTTTGGCACCAAGATACA: CTTTGGCACCAAGATACAA
TAAACCCAGCTATTGAATA: AAACCCAGCTATTGAATAC
TCACTTAAAATGTTCAGGA: CACTTAAAATGTTCAGGAG
GGACTTTTAAGACCGCAAA: GACTTTTAAGACCGCAAAG
GAACTATTGGTCCATGTAC: AACTATTGGTCCATGTACT
GGGAGCGACGAACACACAA: GGAGCGACGAACACACAAG
ATAACCGATCATAAGCTCG: TAACCGATCATAAGCTCGT
TCAGACGGTGCGAGCAACA: CAGACGGTGCGAGCAACAT
GCTGTCGAGGTACACCCCC: CTGTCGAGGTACACCCCCT
AGTCGCGTCGCCAACGAAA: GTCGCGTCGCCAACGAAAT
CAACTATAATAATCCGTCT: AACTATAATAATCCGTCTG
AACGCCTCGTAGGTACTCA: ACGCCTCGTAGGTACTCAT
ATATGGCATCCTCAATGCC: TATGGCATCCTCAATGCCT
CATCTTGATAAGGCGAGCA: ATCTTGATAAGGCGAGCAG
CTCCCGATCGAAGGTACTC: TCCCGATCGAAGGTACTCG
CTTGGCGTTGCCAAGTGGA: TTGGCGTTGCCAAGTGGAG
CCTTTTTCTCGTAAGAGCC: CTTTTTCTCGTAAGAGCCC
TCGAGCTGAAGAACTTTAG: CGAGCTGAAGAACTTTAGG
CTACCATTCAACATGTATT: TACCATTCAACATGTATTG
TTTGGCGCATCTGCATCTT: TTGGCGCATCTGCATCTTG
AACAGGTGCCTACTGCTGT: ACAGGTGCCTACTGCTGTC
CGGGCATAGTCCGGGCTTT: GGGCATAGTCCGGGCTTTA
AGAACGCGACTAAATTGCG: GAACGCGACTAAATTGCGT
AGACACAGCAGCAGTACTT: GACACAGCAGCAGTACTTT
GTACTGTGACTCTGCTTGA: TACTGTGACTCTGCTTGAG
TTATATTGTGGCCACCGAG: TATATTGTGGCCACCGAGG
CCCCGTATGTGCCTGGCCG: CCCGTATGTGCCTGGCCGG
CTTTATGGATATTACGGGA: TTTATGGATATTACGGGAT
TACATGATCTGGCGCCATG: ACATGATCTGGCGCCATGC
TTACGGACCCCAATCGTAG: TACGGACCCCAATCGTAGT
ACGACGGTGCCATATTTCT: CGACGGTGCCATATTTCTC
CGTATGTGCCTGGCCGGCG: GTATGTGCCTGGCCGGCGG
CATCTGCATAAGACGCAGC: ATCTGCATAAGACGCAGCT
CGTAAACCAGTGGCAGAAC: GTAAACCAGTGGCAGAACC
TTCTTTGGGTACTCATGAA: TCTTTGGGTACTCATGAAC
TCTTAGATATTTGGAACTA: CTTAGATATTTGGAACTAT
CCATTCAACATGTATTGGC: CATTCAACATGTATTGGCG
CGTAGGTACTCATCTTGAT: GTAGGTACTCATCTTGATA
CGTAAGTAACCCCGTATGT: GTAAGTAACCCCGTATGTG
AGGCAGTACTTTATGGATA: GGCAGTACTTTATGGATAT
AGCCCGGGACAGCTGCCGC: GCCCGGGACAGCTGCCGCC
ACCCCCTATTGCACAGGGA: CCCCCTATTGCACAGGGAG
AGGTAGAGGTATGAACTGG: GGTAGAGGTATGAACTGGG
TACGGACCCCAATCGTAGT: ACGGACCCCAATCGTAGTG
GGGACCCTCGAGCTGAAGA: GGACCCTCGAGCTGAAGAA
GCGGTCGTGATGCTATAAA: CGGTCGTGATGCTATAAAA
GTCTTAGACGTTTGTAAGC: TCTTAGACGTTTGTAAGCC
AACCTACTTGGCGTTGCCA: ACCTACTTGGCGTTGCCAA
CAGCTTAGTCCTTCTTCCG: AGCTTAGTCCTTCTTCCGC
ATTGGGCTGGGGATCCTGG: TTGGGCTGGGGATCCTGGT
TTCTCCATTTCCTTGGGGT: TCTCCATTTCCTTGGGGTG
CCAGCTTCACGCTTGTATC: CAGCTTCACGCTTGTATCT
AGCTTTCTCCCGATCGAAG: GCTTTCTCCCGATCGAAGG
CTGCTGATTATGGTGAGTG: TGCTGATTATGGTGAGTGG
GATACAAATTCTTAACGCG: ATACAAATTCTTAACGCGT
TGCGCACTTAGGTAGAGGT: GCGCACTTAGGTAGAGGTA
GAGACACAGCAGCAGTACT: AGACACAGCAGCAGTACTT
AACGGCAACCCAGCGTAAA: ACGGCAACCCAGCGTAAAC
GTATAACCGATCATAAGCT: TATAACCGATCATAAGCTC
TTGATCTCACAAAGCATCT: TGATCTCACAAAGCATCTT
ATTTGTAGAATTCATCGAG: TTTGTAGAATTCATCGAGA
GTACTTTATGGATATCTTG: TACTTTATGGATATCTTGC
AATTGGAGGCGGCGGGACC: ATTGGAGGCGGCGGGACCC
TTGGGGTGCCACCTAGTAC: TGGGGTGCCACCTAGTACC
AGCTTAGTCCTTCTTCCGC: GCTTAGTCCTTCTTCCGCT
GCAACCAAGGGAACATACA: CAACCAAGGGAACATACAG
CTGACACAGGAAGTAAACT: TGACACAGGAAGTAAACTC
TCATGAACTCGAACTCGTT: CATGAACTCGAACTCGTTG
TAACCCCGTATGTGCCTGG: AACCCCGTATGTGCCTGGC
TCGGGACTACTATATTATA: CGGGACTACTATATTATAC
GCCGACACCAATTGGTCCG: CCGACACCAATTGGTCCGT
TCTCGGCCGCTCGTAAACC: CTCGGCCGCTCGTAAACCA
TGACGGGGGTATACATGAT: GACGGGGGTATACATGATC
CTGCGTTGGAGCTCGAATG: TGCGTTGGAGCTCGAATGT
TTGCCAAGTGGAGTTGAGT: TGCCAAGTGGAGTTGAGTG
GTCAGACGGTGCGAGCAAC: TCAGACGGTGCGAGCAACA
AGGTCAGACGGTGCGAGCA: GGTCAGACGGTGCGAGCAA
TAAGGCGAGCAGGAGACGT: AAGGCGAGCAGGAGACGTG
GCGCAGTACGTTGTAGGCG: CGCAGTACGTTGTAGGCGA
GTTCGCAGTATCCGGCGCC: TTCGCAGTATCCGGCGCCG
CAGCTATTGAATACCAGTA: AGCTATTGAATACCAGTAT
TTTGAGATCATTCTTAGAT: TTGAGATCATTCTTAGATA
GTATCTTTGGCGCATCTGC: TATCTTTGGCGCATCTGCA
ACTTAGGTAGAGGTATGAA: CTTAGGTAGAGGTATGAAC
CGAGCAGGAGACGTGCGCA: GAGCAGGAGACGTGCGCAC
TCAGGCAAGGGCTGCCGTG: CAGGCAAGGGCTGCCGTGA
CCAGCTATTGAATACCAGT: CAGCTATTGAATACCAGTA
ACCGATCATAAGCTCGTAA: CCGATCATAAGCTCGTAAG
GGCGAGCAGGAGACGTGCG: GCGAGCAGGAGACGTGCGC
CGGTCGTGATGCTATAAAA: GGTCGTGATGCTATAAAAG
CCTCGCGATTGTACTTAGG: CTCGCGATTGTACTTAGGC
TGTCTAATTGTCGGGACTA: GTCTAATTGTCGGGACTAC
TTGGGTACTCATGAACTCG: TGGGTACTCATGAACTCGA
TACTCGCAATGCCTCGGGG: ACTCGCAATGCCTCGGGGT
GGTGAGTGGCAGTTCTGAC: GTGAGTGGCAGTTCTGACA
GACCTGGAGTCCCATTGCC: ACCTGGAGTCCCATTGCCT
CATACAGGCAGTACTTTAT: ATACAGGCAGTACTTTATG
GTCTATTCACGCTTGTATC: TCTATTCACGCTTGTATCT
GCGACTAAATTGCGTTTAG: CGACTAAATTGCGTTTAGT
CCCAATCGTAGTGGCCCTC: CCAATCGTAGTGGCCCTCC
CAGGTCAGACGGTGCGAGC: AGGTCAGACGGTGCGAGCA
ACGACGCTGTTCAATTGGG: CGACGCTGTTCAATTGGGC
ATATTATACGTACTGTGAC: TATTATACGTACTGTGACT
TGGAGGCGGCGGGACCCTC: GGAGGCGGCGGGACCCTCG
GAGGCTTTTAACCCACTGA: AGGCTTTTAACCCACTGAT
ATTCAACATGTATTGGCGT: TTCAACATGTATTGGCGTC
AGCTTACGAGTCGAGAAAT: GCTTACGAGTCGAGAAATA
TCGTTGCACGGCAGAGATT: CGTTGCACGGCAGAGATTA
TATCTTGGGTTGGAGACAC: ATCTTGGGTTGGAGACACA
GTTTAGTGACGGGGGTATA: TTTAGTGACGGGGGTATAC
GGCAGTTCTGACACAGGAA: GCAGTTCTGACACAGGAAG
CCACCGAGGCTGCCCTCTG: CACCGAGGCTGCCCTCTGC
ATACGCCCGCGTTCGCAGT: TACGCCCGCGTTCGCAGTA
ACGAGTCGAGAAATACCTG: CGAGTCGAGAAATACCTGC
GAGCGCGTAATGCGGTCCG: AGCGCGTAATGCGGTCCGA
AAAAAAAACAGGTGCCTAC: AAAAAAACAGGTGCCTACT
AACTGGTTCCTTTATAGAT: ACTGGTTCCTTTATAGATT
TAAAAAAAAACAGGTGCCT: AAAAAAAAACAGGTGCCTA
GAGCTGCCCGTTACGGACC: AGCTGCCCGTTACGGACCC
CTGGAGTCCCATTGCCTCG: TGGAGTCCCATTGCCTCGT
GAAATACCTGCGCAGTACG: AAATACCTGCGCAGTACGT
GTGGAGTTGAGTGACGCCT: TGGAGTTGAGTGACGCCTC
TATTCACGCTTGTATCTTT: ATTCACGCTTGTATCTTTG
AACCATTCTCAGGCAAGGG: ACCATTCTCAGGCAAGGGC
GACGCAAGCTTACGAGTCG: ACGCAAGCTTACGAGTCGA
GCGCAGAGGATCAAGTGGA: CGCAGAGGATCAAGTGGAC
GGCAACCCAGCGTAAACTT: GCAACCCAGCGTAAACTTT
CACAGCTAGTGAGAGGCTA: ACAGCTAGTGAGAGGCTAC
ACGTTGTAGGCGAGGCTAG: CGTTGTAGGCGAGGCTAGC
TATGGATCTCGGCCGCTCG: ATGGATCTCGGCCGCTCGT
TTTCCTTGGGGTGCCACCT: TTCCTTGGGGTGCCACCTA
GATAAGGCGAGCAGGAGAC: ATAAGGCGAGCAGGAGACG
TACTTTTCTGAGCGAGCGC: ACTTTTCTGAGCGAGCGCG
GCTATCCTGATATACAAGG: CTATCCTGATATACAAGGC
TGGCATCCTCAATGCCTGC: GGCATCCTCAATGCCTGCA
CGCAAAGCGGGTGCCAGTC: GCAAAGCGGGTGCCAGTCG
AGTATTCTCCATTTCCTTG: GTATTCTCCATTTCCTTGG
ACCCACTGATTCGGGTTTT: CCCACTGATTCGGGTTTTC
AAAAAGGCGGTGTCAGCTT: AAAAGGCGGTGTCAGCTTA
GCAGTACGTTGTAGGCGAG: CAGTACGTTGTAGGCGAGG
TGTATTGGCGTCGCCCACG: GTATTGGCGTCGCCCACGG
CGAACACACAAGAGCCAAT: GAACACACAAGAGCCAATC
GGGCATAGTCCGGGCTTTA: GGCATAGTCCGGGCTTTAA
CGAGGTACACCCCCTATTG: GAGGTACACCCCCTATTGC
CGGGGGTATACATGATCTG: GGGGGTATACATGATCTGG
CACAAGAGCCAATCTATAG: ACAAGAGCCAATCTATAGT
GCCAATCTATAGTGGACGC: CCAATCTATAGTGGACGCA
CGGGACTACTATATTATAC: GGGACTACTATATTATACG
CTGTCGAGGTACACCCCCT: TGTCGAGGTACACCCCCTA
TTGGGTTGGAGACACAGCA: TGGGTTGGAGACACAGCAG
CCTGGAGTCCCATTGCCTC: CTGGAGTCCCATTGCCTCG
GTAGGCGAGGCTAGCGGTC: TAGGCGAGGCTAGCGGTCG
ACCAGTGGCAGAACCGGTA: CCAGTGGCAGAACCGGTAA
TCCTTGGGGTGCCACCTAG: CCTTGGGGTGCCACCTAGT
TTCTCACGCGGTCGCGGTT: TCTCACGCGGTCGCGGTTA
CCCAGCTATTGAATACCAG: CCAGCTATTGAATACCAGT
CACGCGGTCGCGGTTATAT: ACGCGGTCGCGGTTATATT
CGTGGACCTGGAGTCCCAT: GTGGACCTGGAGTCCCATT
TAAACTCGATAGGTAAACC: AAACTCGATAGGTAAACCC
GCGAGCAGGAGACGTGCGC: CGAGCAGGAGACGTGCGCA
CAAGGGAACATACAGGCAG: AAGGGAACATACAGGCAGT
CGCGGTAACATCAGCCCTT: GCGGTAACATCAGCCCTTT
CTTAGACGTTTGTAAGCCT: TTAGACGTTTGTAAGCCTG
TCCTGATATACAAGGCAAA: CCTGATATACAAGGCAAAA
ACATGTGTCTAATTGTCGG: CATGTGTCTAATTGTCGGG
GGGAAGCGCAGAGGATCAA: GGAAGCGCAGAGGATCAAG
ACGGGGGTATACATGATCT: CGGGGGTATACATGATCTG
GAATATGGCATCCTCAATG: AATATGGCATCCTCAATGC
TCCTGGTAACACAGATCGA: CCTGGTAACACAGATCGAT
CTTGATCTCACAAAGCATC: TTGATCTCACAAAGCATCT
ACAAACTAACGTTTAGTCG: CAAACTAACGTTTAGTCGC
AAGACGCAGCTTTCTCCCG: AGACGCAGCTTTCTCCCGA
ACCTGGAGTCCCATTGCCT: CCTGGAGTCCCATTGCCTC
TCAACTATAATAATCCGTC: CAACTATAATAATCCGTCT
ATCTTGCAGCTTCTTCACG: TCTTGCAGCTTCTTCACGC
TAGATTTGTAGAATTCATC: AGATTTGTAGAATTCATCG
TAACACAGATCGATGTCCG: AACACAGATCGATGTCCGC
GCGGTCCGATCACAAACTA: CGGTCCGATCACAAACTAA
CGCCCACGGAGCTATCCTG: GCCCACGGAGCTATCCTGA
ATTAACTGGTTCCTTTATA: TTAACTGGTTCCTTTATAG
TGCGTTTAGTGACGGGGGT: GCGTTTAGTGACGGGGGTA
GGTAATACTGTAGGGATGT: GTAATACTGTAGGGATGTC
AACTAACGTTTAGTCGCGT: ACTAACGTTTAGTCGCGTC
TCGTAGTGGCCCTCCCCCG: CGTAGTGGCCCTCCCCCGA
AGGTATGGATCTCGGCCGC: GGTATGGATCTCGGCCGCT
TCGCGGTTATATTGTGGCC: CGCGGTTATATTGTGGCCA
TGGTGAGTGGCAGTTCTGA: GGTGAGTGGCAGTTCTGAC
GTCAGCTTAGTCCTTCTTC: TCAGCTTAGTCCTTCTTCC
ACAGCAGCAGTACTTTATG: CAGCAGCAGTACTTTATGG
TTGCAGCTTCTTCACGCTT: TGCAGCTTCTTCACGCTTG
GCAGCAGTACTTTATGGAT: CAGCAGTACTTTATGGATA
ACACGACGCTGTTCAATTG: CACGACGCTGTTCAATTGG
ACTTTATGGATATGATTAG: CTTTATGGATATGATTAGC
TCTTGATAAGGCGAGCAGG: CTTGATAAGGCGAGCAGGA
ATGCCTCGGGGTTCTTCGA: TGCCTCGGGGTTCTTCGAG
AGACGTTTGTAAGCCTGTC: GACGTTTGTAAGCCTGTCT
GTCGAGGTACACCCCCTAT: TCGAGGTACACCCCCTATT
CGGTGTCAGCTTAGTCCTT: GGTGTCAGCTTAGTCCTTC
ATAACATGCCTCGGGAAAT: TAACATGCCTCGGGAAATT
TGTCTGATAGAGAGGAGTG: GTCTGATAGAGAGGAGTGG
TTAGGGAAGCGCAGAGGAT: TAGGGAAGCGCAGAGGATC
CACGCTTGTATCTTTGGGC: ACGCTTGTATCTTTGGGCA
AAGGTTTTGAGATCATTCT: AGGTTTTGAGATCATTCTT
TCTTTGGCGCATCTGCATC: CTTTGGCGCATCTGCATCT
GACGCAGCTTTCTCCCGAT: ACGCAGCTTTCTCCCGATC
CTTGTATCTTTGGCGCATC: TTGTATCTTTGGCGCATCT
ACTGGTTCCTTTATAGATT: CTGGTTCCTTTATAGATTT
CCCTCGTTAGAAAGGTTTT: CCTCGTTAGAAAGGTTTTG
TTTGGCTTGATCTCACAAA: TTGGCTTGATCTCACAAAG
TAAGTTGTATAACCGATCA: AAGTTGTATAACCGATCAT
TGATGCTATAAAAGCAGCC: GATGCTATAAAAGCAGCCC
GCTATAAAAGCAGCCCGGT: CTATAAAAGCAGCCCGGTG
CCGATCACAAACTAACGTT: CGATCACAAACTAACGTTT
TCGATGTCCGCACACAGCT: CGATGTCCGCACACAGCTA
GAGCAGGAGACGTGCGCAC: AGCAGGAGACGTGCGCACT
GGGTTGGAGACACAGCAGC: GGTTGGAGACACAGCAGCA
TGGACCTGGAGTCCCATTG: GGACCTGGAGTCCCATTGC
ATCCTGGTAACACAGATCG: TCCTGGTAACACAGATCGA
CACAGATCGATGTCCGCAC: ACAGATCGATGTCCGCACA
ACCAGTATTCTCCATTTCC: CCAGTATTCTCCATTTCCT
TGGATATAGGCCAGTCTAT: GGATATAGGCCAGTCTATT
CGTGCCGGCATATCCAAGT: GTGCCGGCATATCCAAGTC
CTTTTAACCCACTGATTCG: TTTTAACCCACTGATTCGG
TTACCCTCGTTAGAAAGGT: TACCCTCGTTAGAAAGGTT
CTTTTCTGAGCGAGCGCGT: TTTTCTGAGCGAGCGCGTA
GATTAGCCAGCTTCACGCT: ATTAGCCAGCTTCACGCTT
CGAGAAATACCTGCGCAGT: GAGAAATACCTGCGCAGTA
GCACGGTAAGTTGTATAAC: CACGGTAAGTTGTATAACC
AACGAAATACACGACGCTG: ACGAAATACACGACGCTGT
GGTTTTCTTTGGGTACTCA: GTTTTCTTTGGGTACTCAT
CAGAACTATTGGTCCATGT: AGAACTATTGGTCCATGTA
AGTGGCCCTCCCCCGAAGG: GTGGCCCTCCCCCGAAGGG
TATCCGGCGCCGACACCAA: ATCCGGCGCCGACACCAAT
GTGGACTTTTAAGACCGCA: TGGACTTTTAAGACCGCAA
GATTTGTAGAATTCATCGA: ATTTGTAGAATTCATCGAG
CTCGCAATGCCTCGGGGTT: TCGCAATGCCTCGGGGTTC
AAGTCTTAGACGTTTGTAA: AGTCTTAGACGTTTGTAAG
ATTTGGAACTATTAACTGG: TTTGGAACTATTAACTGGT
GTCGCGGTTATATTGTGGC: TCGCGGTTATATTGTGGCC
CCGTATGTGCCTGGCCGGC: CGTATGTGCCTGGCCGGCG
GAAGGGGCACTGCTGATTA: AAGGGGCACTGCTGATTAT
GGTATACATGATCTGGCGC: GTATACATGATCTGGCGCC
GACGGGGGTATACATGATC: ACGGGGGTATACATGATCT
CCTATTGCACAGGGAGCGA: CTATTGCACAGGGAGCGAG
TTGAGTGACGCCTCCCATA: TGAGTGACGCCTCCCATAC
TGGGAGGCTTTTAACCCAC: GGGAGGCTTTTAACCCACT
GTAACATCAGCCCTTTTTC: TAACATCAGCCCTTTTTCT
TGAATACGCCCGCGTTCGC: GAATACGCCCGCGTTCGCA
TGAAACCATTCTCAGGCAA: GAAACCATTCTCAGGCAAG
GAAATACACGACGCTGTTC: AAATACACGACGCTGTTCA
TGGGCTGGGGATCCTGGTA: GGGCTGGGGATCCTGGTAA
GCTAGCGGTCGTGATGCTA: CTAGCGGTCGTGATGCTAT
AACCAGTGGCAGAACCGGT: ACCAGTGGCAGAACCGGTA
TCGCGGTAACATCAGCCCT: CGCGGTAACATCAGCCCTT
CCGTCTGAAACCATTCTCA: CGTCTGAAACCATTCTCAG
TCACAAACTAACGTTTAGT: CACAAACTAACGTTTAGTC
ACGCTTGTATCTTTGGCGC: CGCTTGTATCTTTGGCGCA
TCAGCTTAGTCCTTCTTCC: CAGCTTAGTCCTTCTTCCG
CATGCTGCCAGAACTATTG: ATGCTGCCAGAACTATTGG
CTCGTAAGTAACCCCGTAT: TCGTAAGTAACCCCGTATG
GGTAGAGGTATGAACTGGG: GTAGAGGTATGAACTGGGA
AAGAACTTTAGGGAAGCGC: AGAACTTTAGGGAAGCGCA
TGGCTTGATCTCACAAAGC: GGCTTGATCTCACAAAGCA
CGGCGCCGACACCAATTGG: GGCGCCGACACCAATTGGT
ACTCATCTTGATAAGGCGA: CTCATCTTGATAAGGCGAG
AGTGACGCCTCCCATACAA: GTGACGCCTCCCATACAAC
GGGAAAAGACTACGAGCGC: GGAAAAGACTACGAGCGCA
GACGAACACACAAGAGCCA: ACGAACACACAAGAGCCAA
CCACGGAGCTATCCTGATA: CACGGAGCTATCCTGATAT
CAGGAGCTCATGCAGTACT: AGGAGCTCATGCAGTACTT
AATCGTAGTGGCCCTCCCC: ATCGTAGTGGCCCTCCCCC
ACTTAGGCAATCGCAGGGA: CTTAGGCAATCGCAGGGAC
TTTGTAAGCCTGTCTGATA: TTGTAAGCCTGTCTGATAG
GAATACCAGTATTCTCCAT: AATACCAGTATTCTCCATT
TATACGTACTGTGACTCTG: ATACGTACTGTGACTCTGC
TGCACAGGGAGCGAGTCAC: GCACAGGGAGCGAGTCACA
CTGTAGGGATGTCTGGTCC: TGTAGGGATGTCTGGTCCA
TATTATACGTACTGTGACT: ATTATACGTACTGTGACTC
GGTTCACGCTTGTATCTTT: GTTCACGCTTGTATCTTTG
TTTAAAAAAAAACAGGTGC: TTAAAAAAAAACAGGTGCC
TTCTGACACAGGAAGTAAA: TCTGACACAGGAAGTAAAC
GAATACGCCCGCGTTCGCA: AATACGCCCGCGTTCGCAG
CAGGAGACGTGCGCACTTA: AGGAGACGTGCGCACTTAG
CGAAGGGGCACTGCTGATT: GAAGGGGCACTGCTGATTA
ACACACAAGAGCCAATCTA: CACACAAGAGCCAATCTAT
TGTAGAATTCATCGAGAAC: GTAGAATTCATCGAGAACG
AACACACAAGAGCCAATCT: ACACACAAGAGCCAATCTA
GTGACGACGGTGCCATATT: TGACGACGGTGCCATATTT
AGGGGCACTGCTGATTATG: GGGGCACTGCTGATTATGG
GGTCCATGTACTTTTCTGA: GTCCATGTACTTTTCTGAG
TAAGACGCAGCTTTCTCCC: AAGACGCAGCTTTCTCCCG
GGAGACACAGCAGCAGTAC: GAGACACAGCAGCAGTACT
CTACTGCTGTCGAGGTACA: TACTGCTGTCGAGGTACAC
TATAATAATCCGTCTGAAA: ATAATAATCCGTCTGAAAC
TCAACATGTATTGGCGTCG: CAACATGTATTGGCGTCGC
GCTATTGAATACCAGTATT: CTATTGAATACCAGTATTC
TACACCCCCTATTGCACAG: ACACCCCCTATTGCACAGG
CCTCGGGAAATTGGAGGCG: CTCGGGAAATTGGAGGCGG
TTTGGGCACGGTAAGTTGT: TTGGGCACGGTAAGTTGTA
TCCGCACACAGCTAGTGAG: CCGCACACAGCTAGTGAGA
ACTTTATGGATATTACGGG: CTTTATGGATATTACGGGA
GGTTAAAGGTGTATTCAAC: GTTAAAGGTGTATTCAACT
CTTTATGGATATGATTAGC: TTTATGGATATGATTAGCC
CGCGGGAAAAGACTACGAG: GCGGGAAAAGACTACGAGC
ATATTTGGAACTATTAACT: TATTTGGAACTATTAACTG
TAAGCTCGTAAGTAACCCC: AAGCTCGTAAGTAACCCCG
ATGTCACTTAAAATGTTCA: TGTCACTTAAAATGTTCAG
GGGGTATACATGATCTGGC: GGGTATACATGATCTGGCG
CAGTACTTTATGGATATAG: AGTACTTTATGGATATAGG
TTTGTAGAATTCATCGAGA: TTGTAGAATTCATCGAGAA
TCGAGAACGCGACTAAATT: CGAGAACGCGACTAAATTG
CTAGTGAGAGGCTACCATT: TAGTGAGAGGCTACCATTC
GCCACCTAGTACCTTGCAT: CCACCTAGTACCTTGCATT
GGGAACATACAGGCAGTAC: GGAACATACAGGCAGTACT
GCAGCCCGGTGCTGCTGAG: CAGCCCGGTGCTGCTGAGG
TGCCACCTAGTACCTTGCA: GCCACCTAGTACCTTGCAT
ACGTTTGTAAGCCTGTCTG: CGTTTGTAAGCCTGTCTGA
GACGGTGCGAGCAACATGT: ACGGTGCGAGCAACATGTG
GTATGGATCTCGGCCGCTC: TATGGATCTCGGCCGCTCG
GGTCGCGGTTATATTGTGG: GTCGCGGTTATATTGTGGC
AAGGTACTCGCAATGCCTC: AGGTACTCGCAATGCCTCG
GTGGCAGTTCTGACACAGG: TGGCAGTTCTGACACAGGA
ACGTTTAGTCGCGTCGCCA: CGTTTAGTCGCGTCGCCAA
GTGGCCACCGAGGCTGCCC: TGGCCACCGAGGCTGCCCT
GAAGTAAACTCGATAGGTA: AAGTAAACTCGATAGGTAA
TTGCACGGCAGAGATTAAA: TGCACGGCAGAGATTAAAG
ATGTGCCTGGCCGGCGGTT: TGTGCCTGGCCGGCGGTTG
AGTGGCAGTTCTGACACAG: GTGGCAGTTCTGACACAGG
CCTCGTAGGTACTCATCTT: CTCGTAGGTACTCATCTTG
GGTACACCCCCTATTGCAC: GTACACCCCCTATTGCACA
CCATATTTCTCACGCGGTC: CATATTTCTCACGCGGTCG
GGTACTCGCAATGCCTCGG: GTACTCGCAATGCCTCGGG
TCCATTTCCTTGGGGTGCC: CCATTTCCTTGGGGTGCCA
ATCTCACAAAGCATCTTAC: TCTCACAAAGCATCTTACT
TTTAGGGAAGCGCAGAGGA: TTAGGGAAGCGCAGAGGAT
AGGCTACCATTCAACATGT: GGCTACCATTCAACATGTA
TACTTTACCATCTGCATAA: ACTTTACCATCTGCATAAG
CGCGATTGTACTTAGGCAA: GCGATTGTACTTAGGCAAT
ATCCTCAATGCCTGCAACC: TCCTCAATGCCTGCAACCA
AACTGGGAGGCTTTTAACC: ACTGGGAGGCTTTTAACCC
GCGTAAACTTTGGCACCAA: CGTAAACTTTGGCACCAAG
CTGCCGCCTTCGGTTAAAG: TGCCGCCTTCGGTTAAAGG
GGCACTGCTGATTATGGTG: GCACTGCTGATTATGGTGA
CGCGGTTATATTGTGGCCA: GCGGTTATATTGTGGCCAC
GAACATACAGGCAGTACTT: AACATACAGGCAGTACTTT
GGGACAGCTGCCGCCTTCG: GGACAGCTGCCGCCTTCGG
TTTCTTTGGGTACTCATGA: TTCTTTGGGTACTCATGAA
ACGGAGCTATCCTGATATA: CGGAGCTATCCTGATATAC
AAGCATCTTACTTTACCAT: AGCATCTTACTTTACCATC
ACCTACTTGGCGTTGCCAA: CCTACTTGGCGTTGCCAAG
TGGATATCTTGCAGCTTCT: GGATATCTTGCAGCTTCTT
TCGGGTTTTCTTTGGGTAC: CGGGTTTTCTTTGGGTACT
GTGCCAGTCGCGGTAACAT: TGCCAGTCGCGGTAACATC
TATTCTCCATTTCCTTGGG: ATTCTCCATTTCCTTGGGG
CAAGAGCCAATCTATAGTG: AAGAGCCAATCTATAGTGG
AAACCCAGCTATTGAATAC: AACCCAGCTATTGAATACC
CATTGCCTCGCGTGAATAC: ATTGCCTCGCGTGAATACA
AGGTACTCGCAATGCCTCG: GGTACTCGCAATGCCTCGG
GTAACACAGATCGATGTCC: TAACACAGATCGATGTCCG
TCGGCCGCTCGTAAACCAG: CGGCCGCTCGTAAACCAGT
CGGGACCCTCGAGCTGAAG: GGGACCCTCGAGCTGAAGA
TGTCGGGACTACTATATTA: GTCGGGACTACTATATTAT
TGCGTTGGAGCTCGAATGT: GCGTTGGAGCTCGAATGTC
CTATTAACTGGTTCCTTTA: TATTAACTGGTTCCTTTAT
TTCTTCGAGGTATGGATCT: TCTTCGAGGTATGGATCTC
TTGTATCTTTGGCGCATCT: TGTATCTTTGGCGCATCTG
GAGGCTAGCGGTCGTGATG: AGGCTAGCGGTCGTGATGC
GGGAGCGAGTCACAATCTG: GGAGCGAGTCACAATCTGT
TCTCGTAAGAGCCCGGGAC: CTCGTAAGAGCCCGGGACA
TTGAGCTGCCCGTTACGGA: TGAGCTGCCCGTTACGGAC
AATACCTGCGCAGTACGTT: ATACCTGCGCAGTACGTTG
GTTCAATTGGGCTGGGGAT: TTCAATTGGGCTGGGGATC
CCAATTGGTCCGTGCGCGG: CAATTGGTCCGTGCGCGGG
CGACGCTGTTCAATTGGGC: GACGCTGTTCAATTGGGCT
TTATGGATATTACGGGATT: TATGGATATTACGGGATTG
GATATTACGGGATTGGTTC: ATATTACGGGATTGGTTCA
AGCAGCCCGGTGCTGCTGA: GCAGCCCGGTGCTGCTGAG
TATTGAATACCAGTATTCT: ATTGAATACCAGTATTCTC
GTAACCCCGTATGTGCCTG: TAACCCCGTATGTGCCTGG
AGATCATTCTTAGATATTT: GATCATTCTTAGATATTTG
GCATTGCCTCGCGTGAATA: CATTGCCTCGCGTGAATAC
AACATGTATTGGCGTCGCC: ACATGTATTGGCGTCGCCC
AACATACAGGCAGTACTTT: ACATACAGGCAGTACTTTA
AGTCCTTCTTCCGCTTCAA: GTCCTTCTTCCGCTTCAAG
CTAACGTTTAGTCGCGTCG: TAACGTTTAGTCGCGTCGC
TTAAAAAAAAACAGGTGCC: TAAAAAAAAACAGGTGCCT
GGACGCAAGCTTACGAGTC: GACGCAAGCTTACGAGTCG
GTGCGCACTTAGGTAGAGG: TGCGCACTTAGGTAGAGGT
GAGCTCGAATGTCACTTAA: AGCTCGAATGTCACTTAAA
GGAAGTAAACTCGATAGGT: GAAGTAAACTCGATAGGTA
GGGGTGCCACCTAGTACCT: GGGTGCCACCTAGTACCTT
ATAAGACGCAGCTTTCTCC: TAAGACGCAGCTTTCTCCC
TACGTACTGTGACTCTGCT: ACGTACTGTGACTCTGCTT
TGCCAGAACTATTGGTCCA: GCCAGAACTATTGGTCCAT
TCGCCAACGAAATACACGA: CGCCAACGAAATACACGAC
GCGACGTGACGACGGTGCC: CGACGTGACGACGGTGCCA
CGCCGACACCAATTGGTCC: GCCGACACCAATTGGTCCG
GGTGTCAGCTTAGTCCTTC: GTGTCAGCTTAGTCCTTCT
ATATTGTGGCCACCGAGGC: TATTGTGGCCACCGAGGCT
GTCAACGGCAACCCAGCGT: TCAACGGCAACCCAGCGTA
GCAGTATCCGGCGCCGACA: CAGTATCCGGCGCCGACAC
GGCACCAAGATACAAATTC: GCACCAAGATACAAATTCT
CTGGTAACACAGATCGATG: TGGTAACACAGATCGATGT
TGAGGGGTATCGTGCCGGC: GAGGGGTATCGTGCCGGCA
CCGCCTCGCGATTGTACTT: CGCCTCGCGATTGTACTTA
GATTGTACTTAGGCAATCG: ATTGTACTTAGGCAATCGC
ACACAAGAGCCAATCTATA: CACAAGAGCCAATCTATAG
AGTACGTTGTAGGCGAGGC: GTACGTTGTAGGCGAGGCT
AGCCAATCTATAGTGGACG: GCCAATCTATAGTGGACGC
GTCGGGCATAGTCCGGGCT: TCGGGCATAGTCCGGGCTT
GTAGGGATGTCTGGTCCAA: TAGGGATGTCTGGTCCAAA
GGTGTATTCAACTATAATA: GTGTATTCAACTATAATAA
TTGTGGCCACCGAGGCTGC: TGTGGCCACCGAGGCTGCC
TAGTCCTTCTTCCGCTTCA: AGTCCTTCTTCCGCTTCAA
GTAATACTGTAGGGATGTC: TAATACTGTAGGGATGTCT
ACTGCTGTCGAGGTACACC: CTGCTGTCGAGGTACACCC
ATTGCCTCGCGTGAATACA: TTGCCTCGCGTGAATACAC
GCGGTTGCGGGAGCGACGA: CGGTTGCGGGAGCGACGAA
AGGGGTATCGTGCCGGCAT: GGGGTATCGTGCCGGCATA
ACTGCTGATTATGGTGAGT: CTGCTGATTATGGTGAGTG
TATGGCATCCTCAATGCCT: ATGGCATCCTCAATGCCTG
GTGACGGGGGTATACATGA: TGACGGGGGTATACATGAT
GTACTTTTCTGAGCGAGCG: TACTTTTCTGAGCGAGCGC
TGCACGGCAGAGATTAAAG: GCACGGCAGAGATTAAAGC
ATGTACTTTTCTGAGCGAG: TGTACTTTTCTGAGCGAGC
GGGACTACTATATTATACG: GGACTACTATATTATACGT
GTAAACTCGATAGGTAAAC: TAAACTCGATAGGTAAACC
AGCAGTACTTTATGGATAT: GCAGTACTTTATGGATATA
CGTACTGTGACTCTGCTTG: GTACTGTGACTCTGCTTGA
TTCAACATGTATTGGCGTC: TCAACATGTATTGGCGTCG
TCGATAGGTAAACCCAGCT: CGATAGGTAAACCCAGCTA
AAGCGCAGAGGATCAAGTG: AGCGCAGAGGATCAAGTGG
CGAGGCTGCCCTCTGCCAT: GAGGCTGCCCTCTGCCATA
AGTCGGGCATAGTCCGGGC: GTCGGGCATAGTCCGGGCT
GCTTCTTCACGCTTGTATC: CTTCTTCACGCTTGTATCT
TAGATATTTGGAACTATTA: AGATATTTGGAACTATTAA
AACCGGTAATACTGTAGGG: ACCGGTAATACTGTAGGGA
GGTGCGAGCAACATGTGTC: GTGCGAGCAACATGTGTCT
TTCATCGAGAACGCGACTA: TCATCGAGAACGCGACTAA
TTCCTTGGGGTGCCACCTA: TCCTTGGGGTGCCACCTAG
TACTTTATGGATATAGGCC: ACTTTATGGATATAGGCCA
TGCCCTCTGCCATAGTCAA: GCCCTCTGCCATAGTCAAG
AGGCGAGGCTAGCGGTCGT: GGCGAGGCTAGCGGTCGTG
CCATACAACGCCTCGTAGG: CATACAACGCCTCGTAGGT
TCCATGTACTTTTCTGAGC: CCATGTACTTTTCTGAGCG
CCTCGGGGTTCTTCGAGGT: CTCGGGGTTCTTCGAGGTA
GTTGTAGTTGCACCGCCTC: TTGTAGTTGCACCGCCTCG
GCCTCGCGATTGTACTTAG: CCTCGCGATTGTACTTAGG
TAGCAGGTCAGACGGTGCG: AGCAGGTCAGACGGTGCGA
AAAGTATCTTGGGTTGGAG: AAGTATCTTGGGTTGGAGA
GCCTCGCGTGAATACACTC: CCTCGCGTGAATACACTCT
CACGGCAGAGATTAAAGCG: ACGGCAGAGATTAAAGCGA
CGTTGCACGGCAGAGATTA: GTTGCACGGCAGAGATTAA